birthDate	film.ttl	2
born	ancestry.ttl	2
burialDate	cemetery.ttl	1
contains	cave.ttl	2
date	funeral.ttl	17
deathDate	cemetery.ttl	1
died	cemetery.ttl	1
established	memorial.ttl	2
hasGrave	cemetery.ttl	1
hasMemorial	cemetery.ttl	1
hasName	project.ttl	66
location	funeral.ttl	22
memorialText	cemetery.ttl	1
name	state.ttl	65
occupant	cemetery.ttl	1
occupantDOB	cemetery.ttl	1
occupantDOD	cemetery.ttl	1
consults	counsel.ttl	1
author	memoir.ttl	12
date	gospel.ttl	1
title	memoir.ttl	16
verseInGospel	gospel.ttl	1
verseNumber	gospel.ttl	1
verseText	gospel.ttl	1
verses	gospel.ttl	1
fromLocation	view.ttl	1
hasSubject	desire.ttl	12
hasTime	end.ttl	3
hasViewer	view.ttl	1
hasViewpointExpression	view.ttl	1
hasViewpointSubject	view.ttl	1
atDate	party.ttl	1
atLocation	care.ttl	2
attends	student.ttl	3
hasAge	girl.ttl	13
hasAttendee	event.ttl	2
hasDate	information.ttl	20
hasEnd	end.ttl	8
hasGuest	wedding.ttl	2
hasHost	party.ttl	1
hasLocation	violence.ttl	26
hasOrganizer	event.ttl	2
hasStartDate	plan.ttl	7
hasTheme	party.ttl	1
organizes	activist.ttl	2
hasClothingType	clothing.ttl	1
hasSize	cabin.ttl	7
hasColor	material.ttl	11
age	home.ttl	9
hasShape	eye.ttl	4
affiliation	researcher.ttl	1
age	horse.ttl	13
gender	instance.ttl	4
hasProjectTopic	researcher.ttl	1
locatedIn	state.ttl	3
worksOn	construction.ttl	3
choice	vote.ttl	1
forCandidate	vote.ttl	1
hasVote	vote.ttl	1
hasVoter	vote.ttl	1
inElection	vote.ttl	1
voteFor	vote.ttl	1
voteIn	vote.ttl	1
voter	vote.ttl	1
hasAuthor	audiobook.ttl	22
hasGenre	tale.ttl	6
writtenIn	text.ttl	1
collectorName	collection.ttl	1
hasCollection	collection.ttl	1
hasCreationDate	document.ttl	4
hasItem	auction.ttl	4
isOfType	collection.ttl	1
item	exhibit.ttl	3
owns	home.ttl	2
color	clothe.ttl	6
hasInk	print.ttl	1
prints	print.ttl	1
givesSermon	preacher.ttl	1
hasOccupation	preacher.ttl	1
religiousTopic	preacher.ttl	1
sermonDelivered	preacher.ttl	1
worksAt	doctor.ttl	8
belongToCentury	decade.ttl	1
endsIn	decade.ttl	1
hasEndYear	decade.ttl	1
hasEvent	scene.ttl	3
hasStartYear	decade.ttl	1
startsIn	decade.ttl	1
startsYear	decade.ttl	1
containsJuror	jury.ttl	1
isJurorIn	jury.ttl	1
jurorDutyDays	jury.ttl	1
jurorSelectionProcess	jury.ttl	1
jurySizeOf	jury.ttl	1
createdBy	website.ttl	2
hasStyle	style.ttl	4
cuisine	chef.ttl	1
dish	dinner.ttl	2
experience	captain.ttl	2
specialty	physician.ttl	3
worksIn	professor.ttl	7
year	census.ttl	2
generates	power.ttl	1
transfers	power.ttl	1
owner	property.ttl	2
hasCategory	shop.ttl	2
hasContact	merchant.ttl	1
hasWebsite	merchant.ttl	1
operatesIn	merchant.ttl	1
sells	shop.ttl	2
sellsProduct	merchant.ttl	1
hasChild	ancestor.ttl	4
hasHeight	baby.ttl	3
isMarried	person.ttl	2
hasTruthValue	statement.ttl	3
isTrue	truth.ttl	1
belongsTo	branch.ttl	6
enrolledIn	university.ttl	1
hasDepartment	institution.ttl	3
hasFaculty	university.ttl	1
offeredBy	university.ttl	1
studies	university.ttl	1
teaches	school.ttl	4
teachesCourse	university.ttl	1
containsPhoto	photo.ttl	1
hasDateTaken	photo.ttl	1
hasDescription	issue.ttl	7
hasFileFormat	photo.ttl	1
hasFileName	photo.ttl	1
hasPhotographer	photo.ttl	1
hasPortfolio	photo.ttl	1
hasResolution	image.ttl	2
hasTitle	information.ttl	22
isPublic	photo.ttl	1
isTakenOn	photo.ttl	1
takenBy	photo.ttl	1
amount	debt.ttl	7
hasPrice	trade.ttl	7
price	shop.ttl	2
address	property.ttl	4
product	store.ttl	1
productDescription	store.ttl	1
productName	store.ttl	1
productPrice	store.ttl	1
courtCase	court.ttl	1
dealsWith	court.ttl	1
defends	law.ttl	2
hasJurisdiction	court.ttl	1
hears	court.ttl	1
judge	trial.ttl	2
represents	law.ttl	3
isImplementedBy	protection.ttl	1
isUsedFor	protection.ttl	1
hasMessage	conversation.ttl	1
hasPart	activity.ttl	8
hasSender	mail.ttl	2
hasTopic	speaker.ttl	2
timestamp	conversation.ttl	1
conductedBy	raid.ttl	3
forEmergency	rescue.ttl	1
hasVictim	kidnapping.ttl	3
hasFamilialLoveFor	love.ttl	1
hasPlatonicLoveFor	love.ttl	1
hasRomanticLoveFor	love.ttl	1
hasSelfLove	love.ttl	1
hasArtist	painting.ttl	1
hasMedium	information.ttl	3
description	project.ttl	8
isDetailOf	detail.ttl	1
hasCopyright	image.ttl	1
hasCreator	statue.ttl	2
hasFormat	image.ttl	1
hasWidth	image.ttl	1
isColor	image.ttl	1
isPublished	paper.ttl	2
hasDateOfBirth	baby.ttl	3
hasFirstName	professor.ttl	6
hasFullName	individual.ttl	1
hasGender	baby.ttl	6
hasLastName	professor.ttl	6
hasNationality	worker.ttl	3
hasProvider	service.ttl	2
hasRecipient	mail.ttl	4
involvesActivity	care.ttl	1
providesCare	care.ttl	1
hasInfluenceOn	abolitionism.ttl	1
hasOrigin	character.ttl	4
isAimedAt	abolitionism.ttl	1
artist	song.ttl	1
content	issue.ttl	7
genre	novel.ttl	4
hasLyrics	song.ttl	1
length	volume.ttl	5
publishDate	song.ttl	1
sungBy	song.ttl	1
hasRepresentation	symbol.ttl	1
isUsedIn	carriage.ttl	3
associatedWith	result.ttl	4
endsOn	spring.ttl	1
hasEnd	spring.ttl	1
hasStart	spring.ttl	1
hasTemperature	star.ttl	3
hasWeather	spring.ttl	1
startsOn	spring.ttl	1
endTime	end.ttl	4
hasStudent	school.ttl	3
hasTeacher	school.ttl	2
startTime	history.ttl	3
entryAuthor	entry.ttl	1
entryDate	entry.ttl	1
hasEntry	diary.ttl	2
email	gift.ttl	5
hasDegree	teacher.ttl	1
hasExperience	overseer.ttl	6
school	teacher.ttl	1
teachesSubject	professor.ttl	2
origin	river.ttl	3
settledIn	colonist.ttl	1
hasAttorneyLicense	attorney.ttl	1
hasPracticeArea	attorney.ttl	1
hasYear	citation.ttl	3
instructionTool	instruction.ttl	1
step	instruction.ttl	1
targetAudience	instruction.ttl	1
employer	servant.ttl	1
firstName	governor.ttl	3
hires	servant.ttl	1
jobTitle	servant.ttl	1
lastName	governor.ttl	4
worksFor	editor.ttl	2
hasSpouse	widow.ttl	3
isWifeOf	wife.ttl	1
hasProficiency	skill.ttl	1
hasSkill	practice.ttl	4
isRelatedTo	principle.ttl	2
ownsSkill	skill.ttl	1
relatedTo	idea.ttl	2
usedInField	skill.ttl	1
hasInterestRate	bond.ttl	1
hasMaturityDate	bond.ttl	1
issuedBy	bond.ttl	1
ownedBy	transportation.ttl	2
hasOrder	list.ttl	1
item	list.ttl	1
hasCity	location.ttl	5
hasCountry	location.ttl	5
hasParcel	land.ttl	1
hasState	address.ttl	2
population	state.ttl	6
size	clothe.ttl	7
hasAgenda	meeting.ttl	1
hasNotes	meeting.ttl	1
hasRecollection	recollection.ttl	1
recollectionDate	recollection.ttl	1
recollectionEvent	recollection.ttl	1
celebratedBy	anniversary.ttl	1
isAnniversaryOf	anniversary.ttl	1
courseDescription	course.ttl	1
courseId	course.ttl	1
courseName	course.ttl	1
hasID	soldier.ttl	3
instructorId	course.ttl	1
instructorName	course.ttl	1
isTaughtBy	course.ttl	1
dateOfDonation	donation.ttl	1
donationAmount	donation.ttl	1
donor	donation.ttl	1
hasEIN	donation.ttl	1
recipient	contribution.ttl	2
endsAt	process.ttl	1
hasInput	conversion.ttl	2
hasOutput	conversion.ttl	2
startsAt	process.ttl	1
cause	damage.ttl	3
effectOfAbolition	abolition.ttl	1
partOf	foot.ttl	3
resultedIn	abolition.ttl	1
lack	lack.ttl	1
xCoordinate	point.ttl	2
yCoordinate	point.ttl	2
zCoordinate	point.ttl	2
hasSkill	seamstress.ttl	1
specializesIn	editor.ttl	3
containsItem	order.ttl	1
customerId	order.ttl	1
itemId	order.ttl	1
itemPrice	sale.ttl	2
itemQuantity	order.ttl	1
hasFirst	pair.ttl	1
hasSecond	pair.ttl	1
usesTool	carpenter.ttl	3
knowledge	blacksmith.ttl	1
tool	blacksmith.ttl	1
displayHonor	honor.ttl	1
hasHonor	honor.ttl	1
isInvolvedIn	public.ttl	1
hasPosition	organization.ttl	2
workInOrganization	official.ttl	1
hasBlue	color.ttl	1
hasGreen	color.ttl	1
hasHexCode	color.ttl	1
hasRGBCode	color.ttl	1
hasRed	color.ttl	1
isPrimaryColor	color.ttl	1
hasCapacity	tavern.ttl	2
hasMake	transportation.ttl	1
hasMaxSpeed	transportation.ttl	1
hasModel	carriage.ttl	2
hasSpeed	ship.ttl	2
operatedBy	transportation.ttl	1
cause	disease.ttl	1
symptom	disease.ttl	1
treatment	disease.ttl	1
advocateFor	abolitionist.ttl	1
participatedIn	abolitionist.ttl	1
hasPart	head.ttl	1
defeats	hero.ttl	1
hasOriginStory	hero.ttl	1
hasPower	hero.ttl	1
hasSuperPower	hero.ttl	1
isMale	hero.ttl	1
secretIdentity	hero.ttl	1
consistsOf	society.ttl	1
hasCulturalNorm	society.ttl	1
hasInstitution	society.ttl	1
hasMember	project.ttl	12
hasRole	project.ttl	7
closingDate	exhibit.ttl	1
curator	exhibit.ttl	1
endDate	project.ttl	6
itemType	exhibit.ttl	1
openingDate	exhibit.ttl	1
startDate	project.ttl	6
belongsToGenre	literature.ttl	1
writtenBy	literature.ttl	1
capacity	vessel.ttl	1
madeOf	clothe.ttl	2
assistanceProvider	assistance.ttl	1
assistanceReceiver	assistance.ttl	1
assistanceType	assistance.ttl	1
providerName	service.ttl	2
receiverName	assistance.ttl	1
belongsIn	community.ttl	1
companyName	work.ttl	1
employeeName	work.ttl	1
employeeNumber	work.ttl	1
jobPosition	work.ttl	1
hasFurniture	office.ttl	3
isPartOf	period.ttl	7
hasCaptain	ship.ttl	1
hasCrew	ship.ttl	1
raceOf	race.ttl	1
depth	sea.ttl	1
hasArea	state.ttl	8
hasDepth	sea.ttl	1
salinity	sea.ttl	1
temperature	sea.ttl	1
courses	ed.ttl	1
dateOfPurchase	purchase.ttl	1
hasBuyer	trade.ttl	2
hasCustomer	sale.ttl	2
hasProduct	trade.ttl	3
hasQuantity	trade.ttl	3
price	purchase.ttl	1
contributedBy	reputation.ttl	1
hasComment	reputation.ttl	1
hasRating	reputation.ttl	1
hasBookingNumber	travel.ttl	1
hasDeparture	travel.ttl	1
hasDestination	passenger.ttl	3
hasDuration	activity.ttl	8
hasTransport	travel.ttl	1
hasImpact	struggle.ttl	3
hasProbability	risk.ttl	1
hasRiskAssessment	risk.ttl	1
hasRiskFactor	risk.ttl	1
hasRiskLevel	risk.ttl	1
hasRiskManagement	risk.ttl	1
hasTotal	total.ttl	1
isItemOf	total.ttl	1
hasDeadline	project.ttl	3
hasOpportunity	opportunity.ttl	1
establishedOn	fact.ttl	1
hasFact	fact.ttl	1
refersSubject	fact.ttl	1
validatedBy	fact.ttl	1
hasPartner	couple.ttl	1
hasWeapon	soldier.ttl	2
city	person.ttl	1
country	freedom.ttl	3
livesIn	relation.ttl	2
dealsDamage	attack.ttl	1
hasTarget	attack.ttl	1
hasBiography	obituary.ttl	2
hasPublicationDate	author.ttl	4
attendsCourt	lawyer.ttl	1
hasEducation	lawyer.ttl	1
hasLicense	lawyer.ttl	1
hasSpecialization	doctor.ttl	3
practicesArea	lawyer.ttl	1
causes	change.ttl	3
dueTo	loss.ttl	1
isMeasuredIn	loss.ttl	1
member	project.ttl	2
hasCastle	kingdom.ttl	1
hasKing	kingdom.ttl	1
hasPrince	kingdom.ttl	1
hasPrincess	kingdom.ttl	1
hasQueen	kingdom.ttl	1
hasBirthDate	birth.ttl	4
hasBreed	life.ttl	1
hasDeathDate	life.ttl	1
memberCount	group.ttl	1
hasAddress	neighbor.ttl	6
hasInvitation	guest.ttl	1
isAttendingEvent	guest.ttl	1
status	guest.ttl	1
stayDuration	guest.ttl	1
staysAt	guest.ttl	1
producedBy	release.ttl	1
version	release.ttl	1
enrolls	student.ttl	1
hasGPA	student.ttl	1
hasMajor	student.ttl	1
hasMinor	student.ttl	1
handlesFire	fire.ttl	1
hasSeverity	pain.ttl	5
hasSource	testimony.ttl	4
producesHeat	fire.ttl	1
producesLight	fire.ttl	1
producesSmoke	fire.ttl	1
triggers	fire.ttl	1
providedBy	support.ttl	1
providesSupport	support.ttl	1
providesSupportTo	support.ttl	1
receivesSupport	support.ttl	1
representsSupportIn	support.ttl	1
from	escape.ttl	1
method	escape.ttl	1
reason	escape.ttl	1
time	escape.ttl	1
to	escape.ttl	1
hasBelief	pilgrimage.ttl	2
hasBeliever	belief.ttl	1
hasContent	newspaper.ttl	8
hasEvidence	belief.ttl	1
hasStrength	belief.ttl	1
hasRoom	home.ttl	2
captivityState	captivity.ttl	1
duration	period.ttl	6
sideEffects	treatment.ttl	1
treats	treatment.ttl	1
type	dress.ttl	5
hasRank	soldier.ttl	3
hasReceivedMedal	veteran.ttl	1
hasServedInWar	veteran.ttl	1
hasServiceLength	veteran.ttl	1
hasCapital	region.ttl	3
hasPopulation	state.ttl	10
isInContinent	country.ttl	1
hasBeneficiaryGroup	emancipation.ttl	1
hasType	material.ttl	10
actsOnBehalfOf	behalf.ttl	1
reads	reader.ttl	1
hasOffender	assault.ttl	1
occurredAt	assault.ttl	1
hasCurrency	earning.ttl	2
hasExchangeRate	money.ttl	1
involves	money.ttl	1
authors	biographer.ttl	1
hasWritten	author.ttl	2
isAbout	activist.ttl	2
isSubjectOf	biographer.ttl	1
isWrittenBy	diary.ttl	2
residesIn	neighbor.ttl	2
hasDenomination	church.ttl	2
hasPurpose	punishment.ttl	3
isPrayedBy	prayer.ttl	1
dateOfBirth	physician.ttl	1
hasPatient	physician.ttl	1
phone	physician.ttl	1
endOfYear	year.ttl	1
hasYear	year.ttl	1
hasOwner	residence.ttl	7
hasValue	level.ttl	7
hasPublished	historian.ttl	1
studiesPeriod	historian.ttl	1
writesAbout	historian.ttl	1
hasEndTime	period.ttl	6
hasStartTime	period.ttl	5
isInTimezone	time.ttl	1
belongsChurch	priest.ttl	1
performs	agent.ttl	2
hasBirthdate	autobiography.ttl	1
conductsService	congregation.ttl	1
area	island.ttl	3
height	volume.ttl	3
width	volume.ttl	3
hasCountySeat	county.ttl	1
inState	county.ttl	1
locatedInState	county.ttl	1
contributor	contribution.ttl	1
hasCharacter	tale.ttl	2
hasCharacters	tale.ttl	2
hasGenreName	film.ttl	2
hasPlot	tale.ttl	2
intensity	effect.ttl	1
result	effect.ttl	1
hasDateTime	violence.ttl	2
hasKidnapper	kidnapping.ttl	1
hasRansom	kidnapping.ttl	1
casualties	battle.ttl	1
combatant	battle.ttl	1
forceSize	battle.ttl	1
hasParticipatingCountry	battle.ttl	1
hasResult	battle.ttl	1
participant	result.ttl	2
place	battle.ttl	1
sideA	battle.ttl	1
sideB	battle.ttl	1
currency	nation.ttl	3
hasInvestment	fund.ttl	1
dueDate	task.ttl	3
effortInvested	effort.ttl	1
effortUnit	effort.ttl	1
taskName	effort.ttl	1
abolitionActivity	antislavery.ttl	1
participatesIn	activism.ttl	4
wrotePublication	antislavery.ttl	1
material	dress.ttl	2
shape	thing.ttl	1
abolishedSlavery	slavery.ttl	1
hasMaster	slavery.ttl	1
helpedEscape	slavery.ttl	1
involvedInTrade	slavery.ttl	1
ownsSlave	slavery.ttl	1
tradedSlaves	slavery.ttl	1
birthCountry	origin.ttl	1
birthYear	origin.ttl	1
hasCityOfOrigin	origin.ttl	1
hasCountryOfOrigin	origin.ttl	1
hasOrigin	origin.ttl	1
hasYearOfOrigin	origin.ttl	1
manufacturingCountry	origin.ttl	1
manufacturingYear	origin.ttl	1
originatedAt	origin.ttl	1
originatedFrom	origin.ttl	1
isbn	book.ttl	2
pageCount	publication.ttl	1
publisher	press.ttl	2
year	publication.ttl	1
hasConversionFactor	conversion.ttl	1
hasInputUnit	conversion.ttl	1
hasOutputUnit	conversion.ttl	1
unitName	conversion.ttl	1
unitSymbol	conversion.ttl	1
hasPet	boy.ttl	1
playsSport	boy.ttl	1
area	settlement.ttl	1
dateOccurred	circumstance.ttl	1
hasEffect	circumstance.ttl	1
hasFactor	success.ttl	2
hasTimeFrame	circumstance.ttl	1
involvedPerson	history.ttl	2
occursAt	change.ttl	2
occursIn	circumstance.ttl	1
outcome	circumstance.ttl	1
earner	earning.ttl	1
hasInstance	instance.ttl	1
hasInstanceTime	instance.ttl	1
isInstanceOf	instance.ttl	1
hasLeader	expedition.ttl	1
hasStartLocation	expedition.ttl	1
founded	publisher.ttl	1
publishes	obituary.ttl	2
bestFriend	friendship.ttl	1
friend	friendship.ttl	1
friendshipFromDate	friendship.ttl	1
hasFriend	friendship.ttl	1
hasRegion	homeland.ttl	1
officialLanguage	homeland.ttl	1
worksInIndustry	laborer.ttl	1
bornIn	native.ttl	1
countryOfOrigin	native.ttl	1
nativeLanguage	native.ttl	1
origin	native.ttl	1
speaks	native.ttl	1
frequency	wage.ttl	1
actsIn	agent.ttl	2
hasAward	actor.ttl	1
hasTexture	cotton.ttl	1
isOrganic	cotton.ttl	1
hasBeneficiary	pension.ttl	1
hasFunding	pension.ttl	1
hasPensionPlan	pension.ttl	1
hasRetiree	pension.ttl	1
hasStartAge	pension.ttl	1
hasTerm	politician.ttl	2
monthlyAmount	pension.ttl	1
startAge	pension.ttl	1
hasAttempt	attempt.ttl	1
hasObject	desire.ttl	2
success	attempt.ttl	1
classIn	school.ttl	1
hasClass	school.ttl	1
hasGrade	institution.ttl	2
ontology	school.ttl	1
studying	school.ttl	1
gaveTestimony	witness.ttl	1
hasWitness	witness.ttl	1
performs	favor.ttl	1
receives	favor.ttl	1
evaluate	study.ttl	1
evaluateResult	study.ttl	1
hasResearcher	study.ttl	1
hasStudyField	study.ttl	1
hasResponse	suffering.ttl	2
orgName	supporter.ttl	1
orgType	supporter.ttl	1
supportedBy	supporter.ttl	1
supportedOrganization	supporter.ttl	1
supports	supporter.ttl	1
hasArrivalEntity	arrival.ttl	1
hasArrivalLocation	arrival.ttl	1
hasArrivalMode	arrival.ttl	1
hasArrivalTime	arrival.ttl	1
hasPerson	arrival.ttl	1
abbreviation	unit.ttl	1
conversionFactor	acre.ttl	2
unitsOf	unit.ttl	1
endPoint	line.ttl	1
startPoint	line.ttl	1
startingPoint	line.ttl	1
x	line.ttl	1
y	line.ttl	1
hasChild	parent.ttl	1
hasParent	mother.ttl	5
hasSibling	relation.ttl	3
concerns	controversy.ttl	1
hasActor	film.ttl	3
hasStakeholder	controversy.ttl	1
participatesIn	controversy.ttl	1
belongsGroup	rebel.ttl	1
hasCause	health.ttl	10
usesWeapon	rebel.ttl	1
hasNumericValue	value.ttl	1
isCauseOf	cause.ttl	1
auntOf	relative.ttl	1
cousinOf	relative.ttl	1
fatherOf	relative.ttl	1
grandFatherOf	relative.ttl	1
grandMotherOf	relative.ttl	1
motherOf	relative.ttl	1
sibling	uncle.ttl	2
uncleOf	relative.ttl	1
hasStatus	request.ttl	2
capital	state.ttl	2
hasCode	nation.ttl	1
hasContinent	nation.ttl	1
isInRegion	nation.ttl	1
affectedObject	damage.ttl	1
affects	fate.ttl	2
causedBy	smallpox.ttl	2
hasConsequence	damage.ttl	1
severity	punishment.ttl	2
timeOfOccurrence	damage.ttl	1
forPurpose	use.ttl	1
hasUse	use.ttl	1
computationMethod	mean.ttl	1
hasIndividualNumber	mean.ttl	1
hasMeanValue	mean.ttl	1
hasNumberSet	mean.ttl	1
value	mean.ttl	1
publishedDate	writing.ttl	1
affectedBy	influence.ttl	1
hasInfluence	influence.ttl	1
hasInfluenceFactor	influence.ttl	1
hasInfluencePower	influence.ttl	1
influencedBy	influence.ttl	1
hasAncestor	ancestor.ttl	2
hasDescendant	ancestry.ttl	1
hasFather	birth.ttl	4
hasMother	mother.ttl	4
hasPlaceOfBirth	ancestry.ttl	1
hasFunction	institution.ttl	1
hasFruit	plantation.ttl	1
hasHerb	plantation.ttl	1
hasTree	plantation.ttl	1
sizeInHectares	plantation.ttl	1
hasSlave	slaveholder.ttl	2
hasDirection	force.ttl	1
hasMagnitude	force.ttl	1
isTypeOf	relationship.ttl	2
hasMajority	majority.ttl	1
voteCount	majority.ttl	1
hasCandidate	politic.ttl	1
hasParty	politic.ttl	1
hasPolitician	politic.ttl	1
hasConclusion	end.ttl	2
hasPremise	argument.ttl	1
belongsCountry	president.ttl	1
hadPreviousPosition	president.ttl	1
hasTerm	president.ttl	1
brother	brother.ttl	1
sibling	brother.ttl	1
hasAxle	wagon.ttl	1
hasWheel	wagon.ttl	1
belongsToDomain	idea.ttl	1
hasDateCreated	idea.ttl	1
hasIdea	idea.ttl	1
governsRDF	governor.ttl	1
hasGovernor	governor.ttl	1
periodOfGovernance	governor.ttl	1
stateGoverned	governor.ttl	1
termEnd	governor.ttl	1
termStart	governor.ttl	1
activityHasDifficulty	difficulty.ttl	1
hasDirector	film.ttl	2
hasScript	play.ttl	1
performance	play.ttl	1
hasManager	project.ttl	2
hasOpeningHours	tavern.ttl	1
servesAlcohol	tavern.ttl	1
servesAlcoholicBeverages	tavern.ttl	1
happenedDuring	history.ttl	1
personName	history.ttl	1
placeName	history.ttl	1
tookPlaceIn	history.ttl	1
hasRelationship	relationship.ttl	1
hasAbility	character.ttl	2
hasRewardType	reward.ttl	1
hasDesigner	suit.ttl	1
caseID	case.ttl	1
caseName	case.ttl	1
caseStatus	case.ttl	1
tradeAmount	trader.ttl	1
tradeItem	trader.ttl	1
tradeValue	trader.ttl	1
trades	trading.ttl	2
bestowAuthority	authority.ttl	1
grantedBy	manumission.ttl	2
hasAuthority	authority.ttl	1
holdsPosition	politician.ttl	2
isDeterminedBy	fate.ttl	1
entry	diary.ttl	1
writer	diary.ttl	1
hasIdentifier	record.ttl	1
employedBy	worker.ttl	1
hasJobTitle	adulthood.ttl	2
creationDate	website.ttl	1
domain	website.ttl	1
hasEmail	mail.ttl	2
skillLevel	website.ttl	1
skillName	website.ttl	1
url	website.ttl	1
source	water.ttl	3
hasItemCondition	return.ttl	1
hasItemName	return.ttl	1
hasPolicyDetail	return.ttl	1
hasPolicyNumber	return.ttl	1
hasReturnDate	return.ttl	1
hasReturnItem	return.ttl	1
hasReturnPolicy	return.ttl	1
hasReturnReason	return.ttl	1
hasReturnedItem	return.ttl	1
createdOn	account.ttl	1
hasBalance	account.ttl	1
hasUser	permission.ttl	2
username	account.ttl	1
guardsPlace	guard.ttl	1
hasDuty	priesthood.ttl	3
hasEquipped	guard.ttl	1
hasShift	guard.ttl	1
hasContract	contract.ttl	1
parties	contract.ttl	1
terms	contract.ttl	1
brand	marker.ttl	1
hasCap	marker.ttl	1
isPermanent	marker.ttl	1
tipType	marker.ttl	1
dateOfMarriage	marriage.ttl	1
hasMarriage	marriage.ttl	1
marriageLocation	marriage.ttl	1
diagnosedBy	condition.ttl	1
diagnosedWith	condition.ttl	1
hasCondition	condition.ttl	1
hasSymptom	health.ttl	2
hasTreatment	health.ttl	2
activismType	activist.ttl	1
birthdate	activist.ttl	1
campaignsFor	activist.ttl	1
causesSupported	activist.ttl	1
fightsFor	activist.ttl	1
hasActivity	activist.ttl	1
isAffiliatedWith	activist.ttl	1
nationality	activist.ttl	1
organisationAffiliated	activist.ttl	1
protests	activist.ttl	1
eradicatedBy	smallpox.ttl	1
preventedBy	smallpox.ttl	1
hasCalorieCount	meal.ttl	1
hasCalories	meal.ttl	1
hasComponent	system.ttl	2
hasCookingTime	meal.ttl	1
hasCuisine	meal.ttl	1
hasIngredient	dinner.ttl	2
hasMealType	meal.ttl	1
isGlutenFree	meal.ttl	1
isVegan	meal.ttl	1
isVegetarian	meal.ttl	1
appointedBy	judge.ttl	2
diocese	bishop.ttl	1
hasLength	coast.ttl	3
hasNumberOfLanes	road.ttl	1
hasSurfaceType	road.ttl	1
hasTrafficVolume	road.ttl	1
isInCountry	road.ttl	1
includesTask	plan.ttl	1
taskHasDuration	plan.ttl	1
taskHasName	plan.ttl	1
taskHasPriority	plan.ttl	1
hosts	occasion.ttl	1
directedBy	film.ttl	1
hasActorName	film.ttl	1
hasReleaseYear	film.ttl	1
releaseDate	film.ttl	1
starring	film.ttl	1
hasBadgeNumber	officer.ttl	1
isAssignedTo	task.ttl	2
servesInDepartment	officer.ttl	1
hasLevel	level.ttl	3
level	ability.ttl	1
requiredFor	ability.ttl	1
hasAgeDistribution	population.ttl	1
hasGenderRatio	population.ttl	1
totalPopulation	census.ttl	2
crime	prisoner.ttl	1
dateOfImprisonment	prisoner.ttl	1
dateOfRelease	prisoner.ttl	1
inPrison	prisoner.ttl	1
prisonerID	prisoner.ttl	1
sentenceDuration	prisoner.ttl	1
sentenceLength	prisoner.ttl	1
sentencedFor	prisoner.ttl	1
earns	adulthood.ttl	1
hasAgeRange	adulthood.ttl	1
hasEmployment	adulthood.ttl	1
hasLegalResponsibility	adulthood.ttl	1
hasPageCount	paper.ttl	1
hasPortion	portion.ttl	1
ofDrink	portion.ttl	1
ofFood	portion.ttl	1
portionOf	portion.ttl	1
portionSize	portion.ttl	1
servingSize	portion.ttl	1
supplies	supply.ttl	1
carries	arter.ttl	1
connectsTo	principle.ttl	2
oxygenated	arter.ttl	1
hasGrandchild	grandchild.ttl	1
isGrandchildOf	grandchild.ttl	1
hasPassenger	passenger.ttl	1
hasTicket	passenger.ttl	1
hasTicketNumber	passenger.ttl	1
isTravelingTo	passenger.ttl	1
ticketNumber	passenger.ttl	1
parent	uncle.ttl	1
hasIntelligence	intelligence.ttl	1
broker	trading.ttl	1
hasAsset	trading.ttl	1
hasVolume	capacity.ttl	2
tradesIn	trading.ttl	1
tradingPlatform	trading.ttl	1
isCommentedOn	comment.ttl	1
hasBasis	basis.ttl	1
hasPhysicalBasis	basis.ttl	1
hasTheoreticalBasis	basis.ttl	1
hasFeeling	feeling.ttl	1
usesBondage	bondage.ttl	1
conductedIn	census.ttl	1
groundType	ground.ttl	1
hasGroundComposition	ground.ttl	1
hasSurfaceTexture	ground.ttl	1
hasMentalStrength	strength.ttl	1
hasPhysicalStrength	strength.ttl	1
strengthLevel	strength.ttl	1
edits	editor.ttl	1
arrestRecord	arrest.ttl	1
arrestedBy	arrest.ttl	1
chargedWith	arrest.ttl	1
documentedBy	arrest.ttl	1
hasArrestee	arrest.ttl	1
hasArrestor	arrest.ttl	1
hasReason	arrest.ttl	1
breed	horse.ttl	1
hasSpouseDeathDate	widow.ttl	1
wasMarried	widow.ttl	1
endYear	rebellion.ttl	1
hasOutcome	decision.ttl	2
hasRebel	rebellion.ttl	1
leadToRevolution	rebellion.ttl	1
startYear	rebellion.ttl	1
hasCommander	regiment.ttl	2
hasSoldier	troop.ttl	1
numberOfSoldiers	troop.ttl	1
rank	captain.ttl	3
applies	drag.ttl	1
hasDragName	drag.ttl	1
performer	drag.ttl	1
wears	drag.ttl	1
aidType	aid.ttl	1
donates	aid.ttl	1
donorName	aid.ttl	1
hasAmount	aid.ttl	1
hasDonor	aid.ttl	1
recipientName	aid.ttl	1
facilitatesActivity	missionary.ttl	1
missionaryWork	missionary.ttl	1
teachesGospel	missionary.ttl	1
trainsToPray	missionary.ttl	1
hasConstructionDate	building.ttl	1
hasFloors	building.ttl	1
hasNumberOfFloors	building.ttl	1
hasManufacturer	carriage.ttl	1
hasPassengerCapacity	carriage.ttl	1
hasSpelling	word.ttl	1
isAntonymOf	word.ttl	1
isSynonymOf	word.ttl	1
hasAudience	speaker.ttl	1
cost	tour.ttl	1
destinations	tour.ttl	1
guide	tour.ttl	1
hasGuide	tour.ttl	1
hasTourist	tour.ttl	1
rating	review.ttl	2
hasPartyAffiliation	politician.ttl	1
hasPoliticalParty	politician.ttl	1
hasTermLength	politician.ttl	1
relatedToIssue	politician.ttl	1
representsCountry	politician.ttl	1
hasAbsorbency	black.ttl	1
isBlack	black.ttl	1
isFrom	slaveholder.ttl	1
ownsProperty	slaveholder.ttl	1
areaSize	region.ttl	1
inCountry	pilgrimage.ttl	2
populationSize	region.ttl	1
regionName	region.ttl	1
hasCEO	company.ttl	1
hasEmployeeCount	company.ttl	1
hasIndustry	company.ttl	1
publicationDate	article.ttl	1
servedInWar	soldier.ttl	1
servesIn	soldier.ttl	1
completed	duty.ttl	1
role	duty.ttl	1
humanBirth	infant.ttl	1
weightAtBirth	infant.ttl	1
calories	food.ttl	1
containsFat	food.ttl	1
containsIngredient	food.ttl	1
hasFoodItem	food.ttl	1
hasNutritionInfo	food.ttl	1
hasRecipe	food.ttl	1
postedBy	review.ttl	1
reviewOf	review.ttl	1
activeSince	regiment.ttl	1
assignedTo	task.ttl	2
comprisingOf	regiment.ttl	1
regimentNumber	regiment.ttl	1
hasAlphabet	language.ttl	1
hasDialect	language.ttl	1
usesScript	language.ttl	1
hasGrandfather	grandfather.ttl	1
elicitsFear	fear.ttl	1
accuses	law.ttl	1
presides	law.ttl	1
isMandatory	subject.ttl	1
canPerform	permission.ttl	1
hasPermission	permission.ttl	1
isAllowed	permission.ttl	1
onResource	permission.ttl	1
permits	permission.ttl	1
libertyInCountry	liberty.ttl	1
libertyType	liberty.ttl	1
carpenter	carpenter.ttl	1
worksInProject	carpenter.ttl	1
hasRight	right.ttl	1
isProtectedBy	right.ttl	1
hasCharacteristics	manner.ttl	1
hasIntensity	desire.ttl	3
isOppositeTo	manner.ttl	1
isSimilarTo	manner.ttl	1
connectsStation	railroad.ttl	1
hasStation	railroad.ttl	1
hasTrack	railroad.ttl	1
operatesOn	railroad.ttl	1
runsOn	railroad.ttl	1
servedBy	railroad.ttl	1
stopsAt	railroad.ttl	1
causeOfDeath	death.ttl	1
dateOfDeath	death.ttl	1
hasCauseOfDeath	obituary.ttl	2
hasDeath	death.ttl	1
hasDied	death.ttl	1
hasPlaceOfDeath	obituary.ttl	2
hasTimeOfDeath	death.ttl	1
locationOfDeath	death.ttl	1
hasURL	domain.ttl	1
ownerEmail	domain.ttl	1
ownerName	domain.ttl	1
quantity	resource.ttl	1
hasEconomicIndependence	independence.ttl	1
hasIndividualIndependence	independence.ttl	1
hasPoliticalIndependence	independence.ttl	1
hasMetric	success.ttl	1
hasTimeframe	success.ttl	1
durationOfRest	rest.ttl	1
hasRest	rest.ttl	1
qualityOfRest	rest.ttl	1
eventEnd	end.ttl	1
hasFinalMoment	end.ttl	1
isEndOf	end.ttl	1
hasConflictWith	enemy.ttl	1
hasEnemy	enemy.ttl	1
hasInjuryLocation	injury.ttl	1
hasInjuryType	injury.ttl	1
injuryDate	injury.ttl	1
injurySeverity	injury.ttl	1
freedomIndex	freedom.ttl	1
isAssociatedWith	freedom.ttl	1
dateGranted	manumission.ttl	1
dateOfManumission	manumission.ttl	1
hasManumitted	manumission.ttl	1
involvedSlave	manumission.ttl	1
legalDocument	manumission.ttl	1
manumission	manumission.ttl	1
wasManumittedBy	manumission.ttl	1
hasStreet	location.ttl	2
hasZipCode	address.ttl	1
hasDateOfDeath	obituary.ttl	1
hasDateOfPublication	obituary.ttl	1
hasObituary	obituary.ttl	1
commemorates	memorial.ttl	1
inscription	memorial.ttl	1
wasEstablishedOn	memorial.ttl	1
hasSignatory	petition.ttl	1
hasText	petition.ttl	1
signs	petition.ttl	1
hasDecisionMaker	decision.ttl	1
hasOption	decision.ttl	1
hasFieldOfStudy	scholar.ttl	1
publishedPapers	scholar.ttl	1
hasCoast	coast.ttl	1
hasOcean	coast.ttl	1
isLocationOf	coast.ttl	1
hasLightPollution	night.ttl	1
isFullMoon	night.ttl	1
starVisibility	night.ttl	1
typicalAnimalsActive	night.ttl	1
typicalHumanActivities	night.ttl	1
believerOf	priesthood.ttl	1
belongs	priesthood.ttl	1
ordinationDate	priesthood.ttl	1
serves	priesthood.ttl	1
componentType	system.ttl	1
hasHardware	system.ttl	1
hasSoftware	system.ttl	1
hasSubcomponent	system.ttl	1
isComponentOf	system.ttl	1
subcomponentType	system.ttl	1
forPerson	respect.ttl	1
forValue	respect.ttl	1
inAction	respect.ttl	1
isMutual	respect.ttl	1
isSelf	respect.ttl	1
levelOfRespect	respect.ttl	1
hasDescendent	ancestor.ttl	1
pages	book.ttl	1
publishedYear	memoir.ttl	2
writesBook	book.ttl	1
endureStruggle	struggle.ttl	1
overcomeStruggle	struggle.ttl	1
hasDetail	request.ttl	1
hasId	request.ttl	1
hasTimestamp	request.ttl	1
baptisedBy	baptism.ttl	1
baptisedPerson	baptism.ttl	1
baptismDate	baptism.ttl	1
baptismLocation	baptism.ttl	1
performedBaptism	baptism.ttl	1
receivedBaptism	baptism.ttl	1
dateOfSale	sale.ttl	1
eventHasChance	chance.ttl	1
hasChance	chance.ttl	1
perpetrator	discrimination.ttl	1
propagatorOfDiscrimination	discrimination.ttl	1
recipientOfDiscrimination	discrimination.ttl	1
victim	discrimination.ttl	1
hasBathrooms	home.ttl	2
hasBedrooms	home.ttl	2
owner	cabin.ttl	1
hasToe	foot.ttl	1
hasCharacter	scene.ttl	1
monumentType	monument.ttl	1
yearBuilt	monument.ttl	1
yearEstablished	monument.ttl	1
hasWarrant	fugitive.ttl	1
wantedFor	fugitive.ttl	1
belongsToFamily	prince.ttl	1
hasBook	bibliography.ttl	1
publicationYear	novel.ttl	2
hasLead	research.ttl	1
relatedField	research.ttl	1
researchOutcome	research.ttl	1
researchTopic	research.ttl	1
isMotherOf	woman.ttl	1
hasJournalist	press.ttl	1
publishedIn	author.ttl	2
source	press.ttl	1
hasArticle	newspaper.ttl	1
hasEdition	newspaper.ttl	1
hasPublisher	newspaper.ttl	1
hasEvaluation	result.ttl	1
isResultOf	result.ttl	1
score	result.ttl	1
coordinate	place.ttl	1
contains	water.ttl	1
containsOxygen	water.ttl	1
hasPH	water.ttl	1
isDrinkable	water.ttl	1
isFresh	water.ttl	1
isFreshwater	water.ttl	1
isSaltwater	water.ttl	1
isSeaWater	water.ttl	1
durationOfPossession	possession.ttl	1
possessed	possession.ttl	1
possessor	possession.ttl	1
hasGreeting	introduction.ttl	1
hasIntroduction	introduction.ttl	1
hasOverview	introduction.ttl	1
hasCoordinates	location.ttl	1
hasObject	statement.ttl	1
hasPredicate	statement.ttl	1
hasInmate	prison.ttl	1
hasSecurityLevel	prison.ttl	1
isGuarded	prison.ttl	1
isImprisoned	prison.ttl	1
isInmateOf	prison.ttl	1
hasNumberOfEmployees	overseer.ttl	1
hasResponsibility	overseer.ttl	1
overseesDepartment	overseer.ttl	1
hasEar	face.ttl	1
hasEye	face.ttl	1
hasFeature	face.ttl	1
hasMouth	face.ttl	1
hasNose	face.ttl	1
hasHusband	queen.ttl	1
hasWife	queen.ttl	1
isHero	character.ttl	1
hasFulfilled	promise.ttl	1
hasPromiseContent	promise.ttl	1
hasPromisee	promise.ttl	1
hasPromisor	promise.ttl	1
appliesPrinciple	justice.ttl	1
hasCourt	justice.ttl	1
hasJudge	trial.ttl	3
hasLawyer	courthouse.ttl	2
hasLegalSystem	justice.ttl	1
hearsCase	justice.ttl	1
delta	river.ttl	1
dischargesInto	river.ttl	1
drainageBasin	river.ttl	1
flowsThrough	river.ttl	1
customerName	service.ttl	1
hasConsumer	service.ttl	1
isProvidedBy	service.ttl	1
provides	service.ttl	1
providesService	service.ttl	1
receivesService	service.ttl	1
serviceName	service.ttl	1
perceives	eye.ttl	1
field	style.ttl	1
period	style.ttl	1
hasBackground	background.ttl	1
targets	raid.ttl	1
hasGiftDescription	gift.ttl	1
hasGiftPrice	gift.ttl	1
hasGiftReceiver	gift.ttl	1
hasGiftSender	gift.ttl	1
hasGiftTitle	gift.ttl	1
hasSeller	trade.ttl	1
hasTradeType	trade.ttl	1
hasTrader	trade.ttl	1
isBilledBy	trade.ttl	1
isBoughtBy	trade.ttl	1
isPaidBy	trade.ttl	1
isSoldBy	trade.ttl	1
isFocusedOn	activism.ttl	1
isLocatedIn	village.ttl	2
hasCase	trial.ttl	2
hasCourtroom	courthouse.ttl	1
hasLineCount	poem.ttl	1
containedIn	tale.ttl	1
hasPublicationYear	tale.ttl	1
hasSetting	tale.ttl	1
publishedOn	tale.ttl	1
tellsAbout	tale.ttl	1
campCapacity	camp.ttl	1
campId	camp.ttl	1
campLocation	camp.ttl	1
campType	camp.ttl	1
digitalLiteracyLevel	literacy.ttl	1
hasDigitalLiteracySkill	literacy.ttl	1
hasLanguage	literacy.ttl	1
hasReadingSkill	literacy.ttl	1
hasWritingSkill	literacy.ttl	1
readingLevel	literacy.ttl	1
writingLevel	literacy.ttl	1
body	example.ttl	1
likes	example.ttl	1
activityLocation	activity.ttl	1
activityName	activity.ttl	1
activityTime	activity.ttl	1
activityType	activity.ttl	1
durationOfEnslavement	enslavement.ttl	1
placeOfEnslavement	enslavement.ttl	1
hasAction	mission.ttl	1
hasAgent	mission.ttl	1
missionDuration	mission.ttl	1
missionObjective	mission.ttl	1
missionOrganizer	mission.ttl	1
requiresResource	mission.ttl	1
hasBirth	birth.ttl	1
hasBirthPlace	birth.ttl	1
hasBid	auction.ttl	1
hasBidder	auction.ttl	1
hasBidderName	auction.ttl	1
hasHighestBid	auction.ttl	1
hasStartPrice	auction.ttl	1
hasKitchen	home.ttl	1
hasLivingRoom	home.ttl	1
hasParking	home.ttl	1
hasRooms	home.ttl	1
isFurnished	home.ttl	1
halfOf	half.ttl	1
hasDenominator	half.ttl	1
hasHalf	half.ttl	1
hasNumerator	half.ttl	1
isHalfOf	half.ttl	1
defendant	trial.ttl	1
hasDefendant	trial.ttl	1
hasProsecutor	trial.ttl	1
hasVerdict	trial.ttl	1
lawyer	trial.ttl	1
asexualReproduction	reproduction.ttl	1
reproduces	reproduction.ttl	1
sexualReproduction	reproduction.ttl	1
performedBy	kindness.ttl	1
receivesKindness	kindness.ttl	1
hasBody	mail.ttl	1
isRead	mail.ttl	1
isSentOn	mail.ttl	1
hasFormation	cave.ttl	1
hasInhabitant	cave.ttl	1
hasPastor	church.ttl	1
hasService	church.ttl	1
holdsService	church.ttl	1
serviceTime	church.ttl	1
creditor	debt.ttl	1
debtor	debt.ttl	1
interestRate	debt.ttl	1
hasBride	wedding.ttl	1
hasGroom	wedding.ttl	1
discussesBill	legislature.ttl	1
passesBill	legislature.ttl	1
proposesBill	legislature.ttl	1
numberOfPages	novel.ttl	1
employedIn	construction.ttl	1
manages	construction.ttl	1
usesMaterial	construction.ttl	1
speaker	speech.ttl	1
firstOrdained	pastor.ttl	1
leadChurch	pastor.ttl	1
leadConregation	pastor.ttl	1
leadsCongregation	pastor.ttl	1
pastorsChurch	pastor.ttl	1
preachSermon	pastor.ttl	1
providesCounseling	pastor.ttl	1
hasSister	sister.ttl	1
isSisterOf	sister.ttl	1
authoredBy	author.ttl	1
bookTitle	author.ttl	1
creativity	genius.ttl	1
intellectualAbility	genius.ttl	1
originality	genius.ttl	1
usedIn	medium.ttl	1
hasResidence	residence.ttl	1
hasResidenceType	residence.ttl	1
hasPiece	piece.ttl	1
isPieceOf	piece.ttl	1
pieceCount	piece.ttl	1
featureDescription	version.ttl	1
featureName	version.ttl	1
hasVersion	version.ttl	1
mainSoftwareFeature	version.ttl	1
softwareName	version.ttl	1
versionNumber	version.ttl	1
versionReleaseDate	version.ttl	1
helpProvider	help.ttl	1
helpReceiver	help.ttl	1
hasWeight	capacity.ttl	2
hasNeighbor	neighbor.ttl	1
locatedOn	neighbor.ttl	1
hasCharge	charge.ttl	1
hasInterest	interest.ttl	1
desireIntensity	desire.ttl	1
desireObject	desire.ttl	1
fulfillsDesire	desire.ttl	1
hasDesire	desire.ttl	1
hasAssignee	issue.ttl	2
isCompleted	task.ttl	1
participants	ceremony.ttl	1
organizer	convention.ttl	1
organizerName	convention.ttl	1
beginsAtTime	level.ttl	1
endsAtTime	level.ttl	1
leasingStatus	property.ttl	1
hasISBN	isbn.ttl	1
publishedBy	audiobook.ttl	2
hasEmployee	office.ttl	1
branchAddress	branch.ttl	1
branchID	branch.ttl	1
branchManager	branch.ttl	1
hasBranch	branch.ttl	1
hasMass	star.ttl	1
isPartOfConstellation	star.ttl	1
fromCountry	pilgrimage.ttl	1
hasPilgrim	pilgrimage.ttl	1
inMonth	pilgrimage.ttl	1
inReligion	pilgrimage.ttl	1
toDestination	pilgrimage.ttl	1
unit	volume.ttl	1
amplifies	principle.ttl	1
contradicts	principle.ttl	1
hasApplication	principle.ttl	1
hasDefinition	principle.ttl	1
hasPrinciple	principle.ttl	1
areaInSquareKm	world.ttl	1
isDirectTowards	violence.ttl	1
isExecutedBy	violence.ttl	1
hasMinutes	hour.ttl	1
hasSeconds	hour.ttl	1
hasElevation	village.ttl	1
attendees	funeral.ttl	1
deceased	funeral.ttl	1
hasDeceased	funeral.ttl	1
hasFuneralDirector	funeral.ttl	1
hasFuneralService	funeral.ttl	1
heldAt	funeral.ttl	1
officiant	funeral.ttl	1
direction	movement.ttl	1
distance	movement.ttl	1
speed	movement.ttl	1
hasSignificantEvent	period.ttl	1
periodType	period.ttl	1
commentary	issue.ttl	1
commenter	issue.ttl	1
hasIssue	issue.ttl	1
hasPriority	issue.ttl	1
hasSubmitter	issue.ttl	1
isOpen	issue.ttl	1
issueCause	issue.ttl	1
issueDescription	issue.ttl	1
issueID	issue.ttl	1
issueResolution	issue.ttl	1
issueStatus	issue.ttl	1
blessingType	blessing.ttl	1
givenBy	testimony.ttl	2
hasBlessing	blessing.ttl	1
hasBlessingType	blessing.ttl	1
isBlessedBy	blessing.ttl	1
receivedBy	blessing.ttl	1
hasDensity	material.ttl	1
hasMeltPoint	material.ttl	1
isFlammable	material.ttl	1
focus	attention.ttl	1
focusDuration	attention.ttl	1
focusIntensity	attention.ttl	1
hasDataType	information.ttl	1
isCreatedBy	information.ttl	1
isDerivedFrom	information.ttl	1
awardsReceived	captain.ttl	1
shipsCommanded	captain.ttl	1
isChildOf	girl.ttl	1
isStudentAt	girl.ttl	1
hasNarrator	audiobook.ttl	1
acquires	knowledge.ttl	1
distributes	knowledge.ttl	1
hasDomainArea	knowledge.ttl	1
hasKnowledge	knowledge.ttl	1
knowsAbout	knowledge.ttl	1
forOffence	punishment.ttl	1
imposes	punishment.ttl	1
isFormOf	punishment.ttl	1
hasChangeMagnitude	change.ttl	1
hasChangeType	change.ttl	1
undergoes	change.ttl	1
deadline	project.ttl	1
manager	project.ttl	1
hasDisease	health.ttl	1
treatsWith	health.ttl	1
catcherPosition	catcher.ttl	1
hasLargestCity	state.ttl	1
hasReigningGovernor	state.ttl	1
appointmentDate	judge.ttl	1
hasJudgment	judge.ttl	1
judges	judge.ttl	1
containsFact	testimony.ttl	1
givenIn	testimony.ttl	1
givenOn	testimony.ttl	1
hasMainSubject	testimony.ttl	1
isVerified	testimony.ttl	1
