color	Eye.ttl	8
dimension	Door.ttl	1
y	Line.ttl	2
hasColor	Eye.ttl	11
hasDimension	Couch.ttl	4
hasHandle	Door.ttl	1
hasHeight	Health.ttl	5
hasLock	Door.ttl	1
hasMaterial	Couch.ttl	7
hasSecurityLevel	Door.ttl	1
id	Lot.ttl	9
isAccessTo	Door.ttl	1
isBarrier	Door.ttl	1
isClosed	Door.ttl	1
isEntranceTo	Door.ttl	1
isLocked	Door.ttl	1
isMadeOf	Thing.ttl	2
isOpen	Issue.ttl	3
isOpenedBy	Door.ttl	1
locatedIn	Team.ttl	13
lockType	Door.ttl	1
madeOf	Art.ttl	3
manufacturer	Car.ttl	7
material	Couch.ttl	7
belongs	Government.ttl	2
belongsTo	Lot.ttl	17
bornOn	President.ttl	1
country	Government.ttl	6
countryServed	President.ttl	1
end	Time.ttl	7
endOfPresidency	President.ttl	1
firstLady	President.ttl	1
hasAfter	President.ttl	1
hasBeenPresident	President.ttl	1
hasBefore	President.ttl	1
hasContinent	World.ttl	2
hasCountry	Lot.ttl	4
hasEnd	End.ttl	7
hasFirstName	Child.ttl	8
hasLastName	Child.ttl	8
hasName	Party.ttl	60
hasNationality	People.ttl	5
hasPopulation	State.ttl	6
hasPresidency	President.ttl	1
hasPresident	President.ttl	1
hasStart	Line.ttl	3
hasTerm	President.ttl	1
hasTermEnd	President.ttl	1
hasTermPeriod	President.ttl	1
hasTermStart	President.ttl	1
inOfficeSince	President.ttl	1
inaugurationDate	President.ttl	1
isPresidentOf	President.ttl	1
predecessor	President.ttl	1
presidencyTerm	President.ttl	1
presidentOf	Government.ttl	2
presidesOver	President.ttl	1
servedAs	President.ttl	1
servedAsPresident	President.ttl	1
servedFrom	President.ttl	1
servedUntil	President.ttl	1
servesAs	President.ttl	1
servesAsPresident	President.ttl	1
servesIn	President.ttl	1
startDate	Team.ttl	10
startOfPresidency	President.ttl	1
successor	President.ttl	1
termEnd	President.ttl	1
termStart	President.ttl	1
wasAffiliatedTo	President.ttl	1
wasBornIn	President.ttl	1
wasBornOn	President.ttl	1
age	Party.ttl	18
attends	Education.ttl	6
description	Idea.ttl	17
gender	Child.ttl	8
groupName	Member.ttl	3
hasAge	Teacher.ttl	26
hasAttribute	Others.ttl	1
hasLocation	Party.ttl	24
hasManufacturer	Car.ttl	6
hasOccupation	Work.ttl	8
hasParameter	Others.ttl	1
hasRelationshipWith	Others.ttl	1
hasShape	Eye.ttl	4
hasSpecies	Life.ttl	2
id	Others.ttl	1
interactsWith	System.ttl	2
isConsideredOther	Others.ttl	1
isProvided	Others.ttl	1
livesIn	People.ttl	7
location	Party.ttl	16
member	Party.ttl	6
name	Party.ttl	50
othersAddress	Others.ttl	1
othersAge	Others.ttl	1
othersGender	Others.ttl	1
othersName	Others.ttl	1
othersNationality	Others.ttl	1
othersOccupation	Others.ttl	1
provide	Party.ttl	13
relatedTo	Side.ttl	4
species	Others.ttl	1
attendance	Student.ttl	1
attendsCourse	Education.ttl	2
attendsUniversity	Student.ttl	1
course	Student.ttl	1
courseCode	Education.ttl	2
courseCredit	Student.ttl	1
courseName	School.ttl	2
courseNumber	Student.ttl	1
courseTitle	Student.ttl	1
enrolledAt	Student.ttl	1
enrolledIn	Education.ttl	5
enrollmentYear	Student.ttl	1
enrollsIn	Student.ttl	1
firstName	Team.ttl	8
grade	School.ttl	2
hasCourse	Education.ttl	4
hasCourseTitle	Student.ttl	1
hasGrade	Education.ttl	5
hasID	Teacher.ttl	6
hasMajor	Student.ttl	1
hasMatriculationID	Student.ttl	1
hasMinor	Student.ttl	1
hasStudent	Teacher.ttl	5
hasUniversityName	Student.ttl	1
isEnrolledIn	School.ttl	4
isEnrolledInCourse	Student.ttl	1
isFullTime	Work.ttl	3
isGraduateStudent	Student.ttl	1
lastName	Team.ttl	8
major	Student.ttl	1
stud_id	Student.ttl	1
studies	Education.ttl	5
studiesAt	Education.ttl	4
studiesCourse	Student.ttl	1
studiesIn	Student.ttl	1
studiesSubject	Education.ttl	2
takes	School.ttl	2
takesCourseFrom	Student.ttl	1
teaches	Teacher.ttl	7
year	Car.ttl	3
brand	Couch.ttl	3
depth	Couch.ttl	3
hasColour	Chair.ttl	3
hasDimensions	Couch.ttl	2
hasSize	Lot.ttl	11
hasStyle	Art.ttl	6
hasUpholstery	Couch.ttl	2
height	Man.ttl	3
isPartOf	Eye.ttl	24
isUpholstered	Couch.ttl	2
isUsedIn	Power.ttl	2
isUsedOutdoors	Loveseat.ttl	1
materialUsed	Loveseat.ttl	1
price	Lot.ttl	5
city	Party.ttl	5
size	Lot.ttl	9
width	Couch.ttl	3
hasDuration	Service.ttl	9
hasMinute	Time.ttl	3
hasMinutes	Day.ttl	3
hasNumber	Level.ttl	6
hasNumberOfMinutes	Hour.ttl	2
hasNumberOfSeconds	Minute.ttl	1
hasNumericValue	Minute.ttl	1
hasSecond	Time.ttl	3
hasTemporalDuration	Hour.ttl	2
hasUnit	Force.ttl	5
isEquivalentTo	Minute.ttl	1
isMinuteIn	Minute.ttl	1
minuteInHour	Minute.ttl	1
minuteInTime	Minute.ttl	1
numericDuration	Minute.ttl	1
ofHour	Minute.ttl	1
partOf	Hand.ttl	7
secondInMinute	Minute.ttl	1
secondInTime	Minute.ttl	1
unit	Power.ttl	2
address	Party.ttl	9
belongsToOffice	Office.ttl	1
computerOn	Office.ttl	1
departmentName	Office.ttl	1
departmentResponsibility	Office.ttl	1
deskIn	Office.ttl	1
email	Member.ttl	3
employee	Work.ttl	3
employeeRole	Office.ttl	1
employees	Office.ttl	1
hasChair	Office.ttl	1
hasComputer	Office.ttl	1
hasDepartment	Government.ttl	4
hasDesk	Office.ttl	1
hasEmployee	Work.ttl	4
hasEquipment	Office.ttl	1
hasFurniture	Home.ttl	3
hasOffice	Office.ttl	1
hasOfficeEquipment	Office.ttl	1
hasOfficeNumber	Office.ttl	1
hasRole	Team.ttl	6
hasRoom	Home.ttl	4
hasStaffMember	Office.ttl	1
hasWorkstation	Office.ttl	1
inCharge	Office.ttl	1
includes	Morning.ttl	2
isOccupied	House.ttl	2
isPartOf	Office.ttl	1
leadsDepartment	Office.ttl	1
manages	Health.ttl	2
number	Year.ttl	2
officeID	Office.ttl	1
officeManager	Office.ttl	1
officeNumber	Office.ttl	1
officeSize	Office.ttl	1
partOf	Office.ttl	1
performTask	Office.ttl	1
phoneNumber	Office.ttl	1
staffName	Office.ttl	1
staffRole	Office.ttl	1
useFurniture	Office.ttl	1
uses	Service.ttl	5
usesChair	Office.ttl	1
usesDesk	Office.ttl	1
usesEquipment	Office.ttl	1
worksAt	Teacher.ttl	6
worksIn	Teacher.ttl	5
worksInDepartment	Office.ttl	1
applies	Law.ttl	1
appliesIn	Law.ttl	1
appliesTo	Law.ttl	1
author	Book.ttl	4
correspondsTo	Law.ttl	1
decides	Law.ttl	1
defendedIn	Law.ttl	1
enactedDate	Law.ttl	1
enforces	Law.ttl	1
follows	Morning.ttl	2
handles	Case.ttl	2
happensInJurisdiction	Law.ttl	1
hasArticle	Law.ttl	1
hasCase	Law.ttl	1
hasCaseNumber	Case.ttl	2
hasCitation	Law.ttl	1
hasConstitution	Law.ttl	1
hasCourt	Law.ttl	1
hasEffectiveDate	Law.ttl	1
hasEnactingBody	Law.ttl	1
x	Line.ttl	2
hasId	Issue.ttl	5
hasJurisdiction	Law.ttl	1
hasLawNumber	Law.ttl	1
hasLegalIssue	Law.ttl	1
hasRepresented	Law.ttl	1
hasStatus	Issue.ttl	3
hasStatute	Law.ttl	1
hasText	Question.ttl	2
hasTitle	Idea.ttl	15
hasY	Line.ttl	4
hasYear	Car.ttl	2
involves	War.ttl	4
isApplicableTo	Law.ttl	1
isEnforcedBy	Right.ttl	2
isRatifiedBy	Law.ttl	1
isSpecializedIn	Law.ttl	1
judgedIn	Law.ttl	1
judges	Law.ttl	1
juridiction	Law.ttl	1
lawSpeciality	Law.ttl	1
passedBy	Law.ttl	1
practice	Law.ttl	1
practices	Law.ttl	1
practicesIn	Law.ttl	1
practicesLaw	Law.ttl	1
represents	Law.ttl	1
title	Work.ttl	13
activities	Night.ttl	1
conceptOfNight	Night.ttl	1
duration	Time.ttl	4
end	Night.ttl	1
endTime	Service.ttl	7
endsAt	War.ttl	4
experiences	Night.ttl	1
hasActivity	Community.ttl	4
hasAurora	Night.ttl	1
hasDarkness	Night.ttl	1
hasEnd	Night.ttl	1
hasEndHour	Night.ttl	1
hasEndTime	End.ttl	11
hasInSky	Night.ttl	1
hasLength	Side.ttl	6
hasMoon	Night.ttl	1
hasMoonPhase	Night.ttl	1
hasNight	Day.ttl	2
hasStar	Night.ttl	1
hasStarVisibility	Night.ttl	1
hasStarsVisible	Night.ttl	1
hasStart	Night.ttl	1
hasStartHour	Night.ttl	1
hasStartTime	Work.ttl	10
hasTemperature	Day.ttl	4
hasWeather	Day.ttl	2
isAstronomicalNight	Night.ttl	1
isDark	Night.ttl	1
isFollowedBy	Night.ttl	1
isIlluminatedBy	Night.ttl	1
isNightOf	Night.ttl	1
isPartOfDay	Hour.ttl	3
isPresentDuring	Night.ttl	1
isQuiet	Night.ttl	1
moonPhase	Night.ttl	1
nightSky	Night.ttl	1
observe	Night.ttl	1
observing	Night.ttl	1
sleeping	Night.ttl	1
start	Night.ttl	1
startTime	Service.ttl	7
startsAt	Day.ttl	3
visibleDuring	Night.ttl	1
weather	Night.ttl	1
date	Party.ttl	5
eventDescription	Moment.ttl	1
fromEvent	Moment.ttl	1
hasBegin	Moment.ttl	1
hasBeginning	Life.ttl	3
hasDate	Party.ttl	10
hasDateTime	Party.ttl	3
hasDescription	Idea.ttl	13
hasEvent	Party.ttl	7
hasInstant	Moment.ttl	1
hasMoment	Moment.ttl	1
hasMomentProperty	Moment.ttl	1
hasPeriod	Art.ttl	3
hasTime	Party.ttl	8
hasTimeInstant	Moment.ttl	1
inLocation	Moment.ttl	1
inTime	Moment.ttl	1
isAfter	Moment.ttl	1
isMomentOf	Moment.ttl	1
isPriorTo	Moment.ttl	1
periodEnd	Art.ttl	2
periodStart	Art.ttl	2
time	Morning.ttl	2
assignedTo	Issue.ttl	2
associatedWith	Level.ttl	4
caseDescription	Case.ttl	1
caseId	Case.ttl	1
caseNumber	Case.ttl	1
caseStatus	Case.ttl	1
caseTitle	Case.ttl	1
caseType	Case.ttl	1
creationDate	Art.ttl	4
dateClosed	Case.ttl	1
dateOpened	Case.ttl	1
hasCaseDate	Case.ttl	1
hasCaseDescription	Case.ttl	1
hasCaseID	Case.ttl	1
hasCaseId	Case.ttl	1
hasCaseName	Case.ttl	1
hasCaseStatus	Case.ttl	1
hasCaseTitle	Case.ttl	1
hasCaseType	Case.ttl	1
hasDateOpened	Case.ttl	1
hasDefendant	Case.ttl	1
hasEndDate	End.ttl	8
hasEntityRole	Case.ttl	1
hasJudge	Case.ttl	1
hasLawyer	Case.ttl	1
hasPart	Eye.ttl	15
hasParty	Case.ttl	1
hasPlaintiff	Case.ttl	1
hasRelatedCase	Case.ttl	1
hasStartDate	Work.ttl	7
hasSubject	Teacher.ttl	7
investigation	Case.ttl	1
investigationEndDate	Case.ttl	1
investigationStartDate	Case.ttl	1
investigator	Case.ttl	1
involvedParties	Case.ttl	1
isRelatedTo	Lot.ttl	4
judge	Case.ttl	1
lawyerName	Case.ttl	1
personName	Issue.ttl	4
representedIn	Case.ttl	1
status	Issue.ttl	2
eyeCount	Head.ttl	1
hasEar	Head.ttl	1
hasEars	Head.ttl	1
hasEye	Eye.ttl	3
hasEyeColor	Head.ttl	1
hasEyes	Face.ttl	2
hasFace	Face.ttl	2
hasForehead	Head.ttl	1
hasHair	Head.ttl	1
hasHairColor	Girl.ttl	2
hasHead	Government.ttl	3
hasMouth	Face.ttl	2
hasNose	Face.ttl	2
hasPart	Head.ttl	1
hasSensoryOrgan	Head.ttl	1
hasSkin	Hand.ttl	3
hasDepth	Chair.ttl	2
hasPrice	Lot.ttl	10
hasWeight	Health.ttl	3
amount	Power.ttl	2
code	Program.ttl	2
coinValue	Money.ttl	1
country	Money.ttl	1
currency	Country.ttl	2
dateIssued	Money.ttl	1
denomination	Money.ttl	1
hasAmount	Money.ttl	1
hasCurrency	Country.ttl	2
hasCurrencyCode	Money.ttl	1
hasDenomination	Money.ttl	1
hasValue	Result.ttl	7
isCurrencyOf	Money.ttl	1
isLegalTender	Money.ttl	1
isLegalTenderIn	Money.ttl	1
issuer	Money.ttl	1
noteValue	Money.ttl	1
pays	Money.ttl	1
performsTransaction	Money.ttl	1
transfers	Money.ttl	1
value	Number.ttl	3
example	Kind.ttl	1
hasCategory	Question.ttl	2
hasCharacter	Story.ttl	2
hasExample	Kind.ttl	1
hasInstances	Kind.ttl	1
hasKind	Kind.ttl	1
hasProperty	Thing.ttl	2
hasQuality	Air.ttl	2
hasSubKind	Kind.ttl	1
hasSuperKind	Kind.ttl	1
hasType	Service.ttl	11
isKindOf	Kind.ttl	1
provide	Kind.ttl	1
studiesFrom	Kind.ttl	1
understandOtherKind	Kind.ttl	1
attendsSchool	Child.ttl	3
goesToSchool	Kid.ttl	1
grade	Kid.ttl	1
guardian	Kid.ttl	1
hasAddress	Lot.ttl	9
hasGender	Health.ttl	12
hasHobby	Girl.ttl	3
hasParent	Child.ttl	10
hasPet	Kid.ttl	1
hasSchoolName	Kid.ttl	1
hasSibling	Child.ttl	6
hasToy	Kid.ttl	1
hobbies	Kid.ttl	1
isParentOf	Child.ttl	4
isStudentOf	Kid.ttl	1
participatesIn	Party.ttl	5
playsSport	Team.ttl	3
school	Teacher.ttl	3
breakfast	Morning.ttl	1
breakfastTime	Morning.ttl	1
coffee	Morning.ttl	1
does	Morning.ttl	1
end_time	Morning.ttl	1
exercise	Morning.ttl	1
hasAlarm	Morning.ttl	1
hasBreakfast	Morning.ttl	1
hasMeal	Morning.ttl	1
hasMorning	Day.ttl	2
hasRoutine	Morning.ttl	1
isEarly	Morning.ttl	1
start_time	Morning.ttl	1
startsWith	Time.ttl	2
sunrise	Morning.ttl	1
wakeup	Morning.ttl	1
workStart	Morning.ttl	1
daughterOf	Mother.ttl	1
givenBirth	Mother.ttl	1
givesBirthTo	Mother.ttl	1
hasChild	Father.ttl	11
hasMother	Man.ttl	5
hasOffspring	Mother.ttl	1
hasRelationship	Mother.ttl	1
hasSpouse	Father.ttl	7
isDaughterOf	Mother.ttl	1
isMarried	People.ttl	5
isMotherOf	Parent.ttl	3
isSonOf	Mother.ttl	1
isWidowed	Mother.ttl	1
mother	Parent.ttl	2
occupation	Community.ttl	3
sonOf	Mother.ttl	1
birthDate	Book.ttl	8
birthdate	Child.ttl	4
child	Girl.ttl	2
childOf	Father.ttl	3
dateOfBirth	People.ttl	2
deathDate	Book.ttl	5
divorceDate	Family.ttl	1
familyMember	Family.ttl	1
father	Parent.ttl	2
hasBirthDate	Party.ttl	4
hasDateOfBirth	Member.ttl	2
hasDaughter	Father.ttl	2
hasFather	Father.ttl	4
hasMember	Party.ttl	7
hasSon	Father.ttl	2
isAlive	Family.ttl	1
isChildOf	Child.ttl	3
isFemale	Family.ttl	1
isMale	Child.ttl	2
isMarriedTo	People.ttl	5
isSiblingOf	Family.ttl	1
marriageDate	Family.ttl	1
married	Family.ttl	1
member	Family.ttl	1
mother	Family.ttl	1
partOfFamily	Family.ttl	1
sibling	Girl.ttl	2
spouseOf	Family.ttl	1
area	Lot.ttl	6
callingCode	Country.ttl	1
capital	State.ttl	4
capitalCity	Country.ttl	1
cityName	State.ttl	3
cityPopulation	Country.ttl	1
continent	World.ttl	2
hasArea	Lot.ttl	10
hasBorderWith	World.ttl	2
hasCapital	State.ttl	3
hasCity	Lot.ttl	4
hasGDP	Country.ttl	1
hasLanguage	Word.ttl	3
hasOfficialLanguage	Country.ttl	1
isInContinent	Country.ttl	1
isLocatedIn	State.ttl	9
isLocatedInContinent	Country.ttl	1
language	Book.ttl	4
officialLanguage	Country.ttl	1
population	State.ttl	7
components	Air.ttl	1
composition	Air.ttl	1
consistsOf	Education.ttl	4
contains	Home.ttl	6
containsCarbonDioxide	Air.ttl	1
containsNitrogen	Air.ttl	1
containsOxygen	Air.ttl	1
hasAirPollution	Air.ttl	1
hasComponent	Face.ttl	3
hasComposition	Air.ttl	1
hasHumidity	Day.ttl	2
hasNitrogen	Air.ttl	1
hasOtherGases	Air.ttl	1
hasOxygen	Air.ttl	1
hasPollutants	Air.ttl	1
hasPollutionLevel	Air.ttl	1
hasPressure	Air.ttl	1
hasQualityIndex	Air.ttl	1
hasVolume	Air.ttl	1
humidity	Air.ttl	1
isComposedOf	Water.ttl	3
isConditioned	Air.ttl	1
isInArea	Air.ttl	1
isPolluted	Water.ttl	2
percentage	Air.ttl	1
pollutant	Air.ttl	1
polluted	Air.ttl	1
pollution	Air.ttl	1
pressure	Air.ttl	1
quality	Air.ttl	1
temperature	Water.ttl	2
abstract	Art.ttl	2
affiliatedInstitution	Research.ttl	1
affiliation	Research.ttl	1
authorOf	Research.ttl	1
conducts	Research.ttl	1
conductsResearch	Research.ttl	1
contributesTo	Research.ttl	1
dueDate	Issue.ttl	2
employs	Work.ttl	4
focusesOn	Research.ttl	1
funding	Research.ttl	1
hasAffiliation	Research.ttl	1
hasAreaOfResearch	Research.ttl	1
hasAuthor	Idea.ttl	7
hasDiploma	Research.ttl	1
hasPublication	Study.ttl	2
hasPublicationDate	Book.ttl	3
hasResearchTopic	Research.ttl	1
hasResearcher	Study.ttl	2
hasSubjectField	Research.ttl	1
hasTopic	Study.ttl	2
has_publication	Research.ttl	1
researcher	Study.ttl	2
inField	Job.ttl	2
institution	Research.ttl	1
isAbout	Fact.ttl	3
isProducedBy	Research.ttl	1
isWrittenBy	Research.ttl	1
outputs	Research.ttl	1
performs	Research.ttl	1
publication	Research.ttl	1
publishedIn	Book.ttl	2
publishes	Research.ttl	1
researchTopic	Research.ttl	1
researchedBy	Research.ttl	1
researcher	Research.ttl	1
resultsIn	Force.ttl	3
specializesIn	Research.ttl	1
study	Research.ttl	1
supports	Research.ttl	1
topic	Research.ttl	1
usesMethod	Research.ttl	1
workAt	Research.ttl	1
areaOfWork	Job.ttl	1
belongsToIndustry	Job.ttl	1
employee	Job.ttl	1
employer	Work.ttl	2
employerName	Job.ttl	1
employmentType	Job.ttl	1
hasCompany	Job.ttl	1
hasEmployer	Work.ttl	2
hasJob	Work.ttl	3
hasJobTitle	Work.ttl	3
hasOrganization	Job.ttl	1
hasPosition	Hand.ttl	5
hasResponsibilities	Job.ttl	1
hasSalary	Work.ttl	3
industry	Business.ttl	3
isPartOfIndustry	Job.ttl	1
jobDescription	Job.ttl	1
jobID	Job.ttl	1
jobId	Job.ttl	1
jobLocation	Job.ttl	1
jobSalary	Job.ttl	1
jobTitle	Work.ttl	3
locationName	Job.ttl	1
positionTitle	Work.ttl	2
postedJob	Job.ttl	1
requiresEducation	Job.ttl	1
requiresExperience	Job.ttl	1
requiresSkill	Job.ttl	1
requiresSkills	Job.ttl	1
salary	Work.ttl	3
skillsRequired	Job.ttl	1
worksAs	Job.ttl	1
worksFor	Work.ttl	2
belongs_to	Point.ttl	1
hasPoint	Line.ttl	2
hasX	Line.ttl	2
hasXCoordinate	Line.ttl	2
hasY	Point.ttl	1
hasYCoordinate	Line.ttl	2
hasZ	Point.ttl	1
hasZCoordinate	Line.ttl	2
isOrigin	Point.ttl	1
locatedInPlane	Point.ttl	1
x	Point.ttl	1
xCoordinate	Line.ttl	2
y	Point.ttl	1
yCoordinate	Line.ttl	2
zCoordinate	Point.ttl	1
areaUnit	Area.ttl	1
areaValue	Area.ttl	1
inSquareMiles	Area.ttl	1
length	Line.ttl	5
radius	Area.ttl	1
sideLength	Area.ttl	1
sides	Area.ttl	1
unit	Area.ttl	1
unitOfMeasure	Force.ttl	2
unitOfMeasurement	Area.ttl	1
existsIn	Community.ttl	2
hasAbstract	Thing.ttl	1
hasSymbol	Thing.ttl	1
hasTexture	Face.ttl	2
isUsedFor	Thing.ttl	1
commonInterest	Friend.ttl	1
friend	Friend.ttl	1
friendOf	Friend.ttl	1
hasCommonInterest	Community.ttl	2
hasFriend	Friend.ttl	1
hasFriendshipEndDate	Friend.ttl	1
hasFriendshipStartDate	Friend.ttl	1
hasKnownSince	Friend.ttl	1
hasPhoneNumber	People.ttl	2
hasSharedExperience	Friend.ttl	1
isClose	Friend.ttl	1
isFriendOf	Friend.ttl	1
isFriendWith	Guy.ttl	2
knownSince	Friend.ttl	1
knows	Friend.ttl	1
knowsSince	Friend.ttl	1
placeMet	Friend.ttl	1
sharedInterests	Friend.ttl	1
sharesInterestWith	Friend.ttl	1
since	Friend.ttl	1
hasHour	Time.ttl	2
hasNumberOfHours	Hour.ttl	1
hasSecond	Hour.ttl	1
hourOfDay	Hour.ttl	1
hourValue	Hour.ttl	1
hours	Hour.ttl	1
isInTimeZone	Hour.ttl	1
developedBy	Program.ttl	2
developer	Program.ttl	2
genre	Book.ttl	4
hasAgeRating	Game.ttl	1
hasDeveloper	Program.ttl	2
hasGenre	Book.ttl	3
hasPlatform	Program.ttl	2
hasPlayer	Game.ttl	1
hasPlayerCount	Game.ttl	1
hasPlayerMode	Game.ttl	1
hasRating	Game.ttl	1
hasReleaseDate	Program.ttl	2
hasReview	Game.ttl	1
hasRule	Game.ttl	1
hasSkillLevel	Game.ttl	1
isAvailableOn	Game.ttl	1
isDevelopedBy	Game.ttl	1
platform	Game.ttl	1
player	Game.ttl	1
playerName	Game.ttl	1
plays	Game.ttl	1
playsGame	Game.ttl	1
publisher	Book.ttl	2
rating	Service.ttl	2
releaseDate	Program.ttl	2
releaseYear	Game.ttl	1
reviewOf	Game.ttl	1
reviewRating	Game.ttl	1
reviewScore	Game.ttl	1
reviewText	Game.ttl	1
wasReleasedIn	Game.ttl	1
actionName	Reason.ttl	1
actionTriggeredBy	Reason.ttl	1
causedBy	Change.ttl	3
causes	End.ttl	4
causesEvent	Reason.ttl	1
derivedFrom	Power.ttl	2
explains	Reason.ttl	1
hasConclusion	Reason.ttl	1
hasEvidence	Reason.ttl	1
hasLogicalBasis	Reason.ttl	1
hasPremise	Reason.ttl	1
hasPurpose	Reason.ttl	1
hasReason	War.ttl	2
justifies	Reason.ttl	1
leadsTo	Way.ttl	3
provides	Service.ttl	7
providesReasonFor	Reason.ttl	1
reason	Reason.ttl	1
reasonFor	Reason.ttl	1
reasonText	Reason.ttl	1
relatedToDecision	Reason.ttl	1
relatedToEvent	Reason.ttl	1
usesReasoningType	Reason.ttl	1
belongsToEra	History.ttl	1
belongsToPeriod	History.ttl	1
content	Information.ttl	2
discovered	History.ttl	1
hadParticipant	History.ttl	1
hasCharacter	History.ttl	1
hasHappenedIn	History.ttl	1
heldIn	Community.ttl	2
influentialPerson	History.ttl	1
involvedIn	History.ttl	1
livedDuring	History.ttl	1
occurredAt	History.ttl	1
occurredDuring	History.ttl	1
occurredIn	History.ttl	1
occursIn	History.ttl	1
participatedIn	History.ttl	1
tookPlaceDuring	History.ttl	1
dimensions	Couch.ttl	2
hasBrand	Car.ttl	3
hasCushion	Couch.ttl	2
hasFabric	Sofa.ttl	1
hasSeats	Sofa.ttl	1
isUsedIn	Sofa.ttl	1
manufacturedBy	Part.ttl	2
numSeats	Sofa.ttl	1
seatsNumber	Sofa.ttl	1
style	Art.ttl	3
type	Service.ttl	5
weight	Question.ttl	4
author	Information.ttl	1
businessAddress	Information.ttl	1
businessName	Information.ttl	1
containsData	Information.ttl	1
containsMetadata	Information.ttl	1
dataType	Information.ttl	1
dateCreated	Information.ttl	1
encodingMethod	Information.ttl	1
encryptionMethod	Information.ttl	1
engagesIn	Information.ttl	1
hasAvailability	Information.ttl	1
hasConfidentiality	Information.ttl	1
hasContent	Question.ttl	3
hasDataType	Information.ttl	1
hasForm	Life.ttl	2
hasInformation	Information.ttl	1
hasIntegrity	Information.ttl	1
hasReference	Information.ttl	1
hasSource	Question.ttl	7
hasTimestamp	Result.ttl	2
information	Information.ttl	1
informationDescription	Information.ttl	1
informationSource	Information.ttl	1
isBasedOn	Information.ttl	1
isBasisFor	Information.ttl	1
isConfidential	Information.ttl	1
isDerivedFrom	Information.ttl	1
isRelevantTo	Information.ttl	1
isStoredIn	Information.ttl	1
isVerified	Fact.ttl	2
relatedInformation	Information.ttl	1
source	Way.ttl	5
birthPlace	Person.ttl	1
bornIn	People.ttl	3
bornOnDate	Person.ttl	1
children	Person.ttl	1
city	Person.ttl	1
isEmployed	People.ttl	3
nationality	Art.ttl	3
phone	Person.ttl	1
postalCode	Person.ttl	1
residence	Person.ttl	1
residesIn	Home.ttl	2
state	Company.ttl	2
street	Company.ttl	3
character	Story.ttl	1
characterName	Story.ttl	1
hasCharacterName	Story.ttl	1
hasCharacters	Story.ttl	1
hasPlot	Story.ttl	1
hasSetting	Story.ttl	1
hasTheme	Party.ttl	2
plot	Story.ttl	1
publicationDate	Book.ttl	2
publicationYear	Book.ttl	2
role	Team.ttl	2
writtenBy	Community.ttl	2
continentOf	World.ttl	1
countryOf	Place.ttl	2
drives	World.ttl	1
hasCity	World.ttl	1
hasLanguage	World.ttl	1
hasMountain	World.ttl	1
hasReligion	World.ttl	1
hasRiver	World.ttl	1
hasSea	World.ttl	1
hosts	World.ttl	1
inContinent	World.ttl	1
inWorld	World.ttl	1
isFamousFor	World.ttl	1
partOfContinent	World.ttl	1
partOfCountry	City.ttl	2
populationOf	World.ttl	1
spokenIn	World.ttl	1
surroundedBy	World.ttl	1
hasBirthdate	Woman.ttl	1
hasChildren	Man.ttl	2
isDaughter	Woman.ttl	1
isEducatedIn	Woman.ttl	1
isMother	Woman.ttl	1
isWifeOf	Woman.ttl	1
isWoman	Woman.ttl	1
womanhasAge	Woman.ttl	1
womanhasName	Woman.ttl	1
womanhasNationality	Woman.ttl	1
addressCountry	Place.ttl	1
addressLocality	Place.ttl	1
containedInPlace	Place.ttl	1
hasLatitude	Place.ttl	1
hasLongitude	Place.ttl	1
hasPostalAddress	Place.ttl	1
latitude	Place.ttl	1
longitude	Place.ttl	1
placeName	Place.ttl	1
postCode	Place.ttl	1
streetAddress	Place.ttl	1
createdOn	Group.ttl	1
establishedDate	Business.ttl	2
groupDescription	Group.ttl	1
groupID	Member.ttl	2
groupMember	Group.ttl	1
groupSize	Group.ttl	1
hasGroupName	Group.ttl	1
hasGroupSize	Group.ttl	1
hasLeader	Party.ttl	6
leader	Community.ttl	2
memberName	Member.ttl	4
memberRole	Team.ttl	2
ofType	Group.ttl	1
accommodates	Room.ttl	1
accommodatesPerson	Room.ttl	1
belongsInFloor	Room.ttl	1
belongsToBuilding	Room.ttl	1
belongsToFloor	Room.ttl	1
capacity	Power.ttl	2
floorArea	Room.ttl	1
hasCapacity	Lot.ttl	2
hasDoor	Home.ttl	3
hasFunction	Eye.ttl	4
hasOccupant	Room.ttl	1
hasRoomNumber	Room.ttl	1
hasWindow	Home.ttl	3
isOccupied	Room.ttl	1
isOfType	Room.ttl	1
number	Room.ttl	1
roomName	Room.ttl	1
roomNumber	Room.ttl	1
roomOccupancy	Room.ttl	1
roomType	House.ttl	2
type	Room.ttl	1
typeOfRoom	Room.ttl	1
boilingPoint	Water.ttl	1
containMinerals	Water.ttl	1
containsSalt	Water.ttl	1
freezingPoint	Water.ttl	1
hardness	Water.ttl	1
hasForm	Water.ttl	1
hasPH	Water.ttl	1
hasPHValue	Water.ttl	1
hasPh	Water.ttl	1
hasPhysicalState	Water.ttl	1
hasSalinity	Water.ttl	1
hasSaltContent	Water.ttl	1
hasState	State.ttl	3
hasWaterProperty	Water.ttl	1
isDrinkingSource	Water.ttl	1
isEssentialFor	Water.ttl	1
isFreshWater	Water.ttl	1
isFrozen	Water.ttl	1
isHabitatFor	Water.ttl	1
isPotable	Water.ttl	1
isSaltWater	Water.ttl	1
isSourceOf	Water.ttl	1
pH	Water.ttl	1
pollutants	Water.ttl	1
salinity	Water.ttl	1
usedIn	Word.ttl	3
water	Water.ttl	1
hasBackyard	House.ttl	1
hasBathrooms	House.ttl	1
hasBedrooms	House.ttl	1
hasGarage	House.ttl	1
hasGarden	House.ttl	1
hasLivingRoom	House.ttl	1
hasNumberOfRooms	Home.ttl	2
hasOwner	Lot.ttl	4
hasRooms	Home.ttl	2
isDetached	House.ttl	1
isOwnedBy	House.ttl	1
numberOfRooms	House.ttl	1
ownedBy	House.ttl	1
owner	Lot.ttl	3
owns	Business.ttl	3
beginningOfDay	Day.ttl	1
dayOfMonth	Day.ttl	1
dayOfWeek	Week.ttl	2
dayOfYear	Day.ttl	1
endOfDay	Day.ttl	1
eventType	Day.ttl	1
hasAfternoon	Day.ttl	1
hasDay	Year.ttl	3
hasDayName	Day.ttl	1
hasDayNumber	Day.ttl	1
hasDayOfMonth	Day.ttl	1
hasDayOfTheWeek	Day.ttl	1
hasDayOfWeek	Day.ttl	1
hasDayOfYear	Day.ttl	1
hasDayPart	Day.ttl	1
hasDaylight	Day.ttl	1
hasDaylightDuration	Day.ttl	1
hasEvening	Day.ttl	1
hasHours	Work.ttl	3
hasPartOfDay	Day.ttl	1
hasPrecipitation	Day.ttl	1
hasSunrise	Day.ttl	1
hasSunset	Day.ttl	1
hasTimeOfDay	Day.ttl	1
hasWeatherCondition	Day.ttl	1
hasWeekday	Day.ttl	1
isHoliday	Day.ttl	1
isPartOfWeek	Day.ttl	1
isWeekday	Day.ttl	1
isWeekend	Day.ttl	1
sunriseTime	Day.ttl	1
sunsetTime	Day.ttl	1
:hasPart	Part.ttl	1
belongsToAssembly	Part.ttl	1
belongs_in	Part.ttl	1
categoryName	Part.ttl	1
hasManufacturerName	Part.ttl	1
hasPartNumber	Part.ttl	1
hasWeight	Part.ttl	1
has_material	Part.ttl	1
has_part	Part.ttl	1
manufacturerName	Part.ttl	1
manufacturerWebsite	Part.ttl	1
manufacturingDate	Part.ttl	1
objectID	Part.ttl	1
partCategory	Part.ttl	1
partDescription	Part.ttl	1
partID	Part.ttl	1
partId	Part.ttl	1
partManufactureDate	Part.ttl	1
partManufacturer	Part.ttl	1
partModel	Part.ttl	1
partName	Part.ttl	1
partNumber	Part.ttl	1
processID	Part.ttl	1
serialNumber	Part.ttl	1
subPart	Part.ttl	1
usesPart	Part.ttl	1
birthday	Guy.ttl	1
employedAs	Guy.ttl	1
hasInterest	Community.ttl	2
colour	Couch.ttl	1
hasCushions	Couch.ttl	1
hasSeatDepth	Couch.ttl	1
hasUpholsteryMaterial	Couch.ttl	1
isConvertible	Couch.ttl	1
isInLivingRoom	Couch.ttl	1
model	Car.ttl	2
affectEnvironment	Power.ttl	1
amountOfPower	Power.ttl	1
calculatesPower	Power.ttl	1
control	Power.ttl	1
generate	Power.ttl	1
hasMagnitude	Force.ttl	2
hasPower	Power.ttl	1
hasPowerOver	Power.ttl	1
isGeneratedBy	Power.ttl	1
isMeasuredIn	Power.ttl	1
measuredIn	Force.ttl	2
powerGeneration	Power.ttl	1
powerMeasure	Power.ttl	1
isFatherOf	Father.ttl	2
belongsIn	Week.ttl	1
dayName	Week.ttl	1
dayNumber	Week.ttl	1
hasDays	Month.ttl	2
hasEndDay	Week.ttl	1
hasSequence	Week.ttl	1
hasStartDay	Week.ttl	1
hasWeek	Week.ttl	1
isDayOf	Week.ttl	1
isDayOfTheWeek	Week.ttl	1
numberOfWeek	Week.ttl	1
beganOn	War.ttl	1
beginsOn	War.ttl	1
belligerent	War.ttl	1
belligerentName	War.ttl	1
casualties	War.ttl	1
casualtiesIn	War.ttl	1
causeOfWar	War.ttl	1
commencesAt	War.ttl	1
consequence	End.ttl	2
dateEnded	War.ttl	1
dateStarted	War.ttl	1
endYear	War.ttl	1
endedOn	War.ttl	1
endsOn	War.ttl	1
endsWith	Time.ttl	2
hasBasicOutcome	War.ttl	1
hasBattle	War.ttl	1
hasBelligerent	War.ttl	1
hasCasualties	War.ttl	1
hasCause	Problem.ttl	3
hasCombatant	War.ttl	1
hasCombatant1	War.ttl	1
hasCombatant2	War.ttl	1
hasConflict	War.ttl	1
hasInvolved	War.ttl	1
hasInvolvedCountry	War.ttl	1
hasMilitary	War.ttl	1
hasOutcome	Result.ttl	2
hasParticipant	War.ttl	1
hasParticipatingCountry	War.ttl	1
hasResult	Result.ttl	5
hasTimeframe	War.ttl	1
hasWarPart	War.ttl	1
involvedCountry	War.ttl	1
involvedParty	War.ttl	1
involvesCountry	War.ttl	1
participant	Community.ttl	2
participatingCountry	War.ttl	1
resultOfWar	War.ttl	1
startYear	War.ttl	1
usesWeapon	War.ttl	1
atLocation	Study.ttl	1
courseOfStudy	Study.ttl	1
focusArea	Study.ttl	1
hasCourse	Study.ttl	1
hasInvestigator	Study.ttl	1
hasLevel	Level.ttl	2
hasMethod	Way.ttl	2
hasStudent	Study.ttl	1
hasStudy	Study.ttl	1
hasStudyArea	Study.ttl	1
hasStudyDate	Study.ttl	1
hasStudyID	Study.ttl	1
hasStudyName	Study.ttl	1
hasStudyTopic	Study.ttl	1
isCourseOf	Study.ttl	1
isInInstitution	Study.ttl	1
isStudiedBy	Study.ttl	1
isStudyBy	Study.ttl	1
isStudying	Study.ttl	1
isTaughtBy	Study.ttl	1
isTutoredBy	Study.ttl	1
partOfCurriculum	Study.ttl	1
reads	Study.ttl	1
student	School.ttl	2
studentID	Education.ttl	2
studentName	School.ttl	2
studiedBy	Study.ttl	1
subject	Teacher.ttl	4
takesPlaceAt	Study.ttl	1
taughtBy	School.ttl	2
uniName	Study.ttl	1
usesSourceMaterial	Study.ttl	1
career	Man.ttl	1
ethnicity	Man.ttl	1
fatherOf	Father.ttl	2
hairColor	Man.ttl	1
hasConcept	Man.ttl	1
isA	Man.ttl	1
manhasAge	Man.ttl	1
manhasName	Man.ttl	1
manhasOccupation	Man.ttl	1
manisMarried	Man.ttl	1
profession	Man.ttl	1
surname	People.ttl	2
atTime	Time.ttl	1
begin	Time.ttl	1
dateTime	Time.ttl	1
dateTimeStamp	Time.ttl	1
days	Time.ttl	1
during	Time.ttl	1
endAt	Time.ttl	1
endedAt	Time.ttl	1
hasTemporalUnit	Time.ttl	1
hasTimezone	Time.ttl	1
inDateTime	Time.ttl	1
inFuture	Time.ttl	1
inPast	Time.ttl	1
inXSDDateTime	Time.ttl	1
inXSDDateTimeStamp	Time.ttl	1
inXSDDuration	Time.ttl	1
isTimePointOf	Time.ttl	1
isUnitOf	Time.ttl	1
startAt	Time.ttl	1
startedAt	Time.ttl	1
hasCalendarOrder	Month.ttl	1
hasMonth	Year.ttl	2
hasNumberOfDays	Month.ttl	1
hasOrder	Month.ttl	1
beginningOfYear	Year.ttl	1
endOfYear	Year.ttl	1
followedBy	Year.ttl	1
hasSeason	Year.ttl	1
inYear	Year.ttl	1
isLeap	Year.ttl	1
isLeapYear	Year.ttl	1
isYearOf	Year.ttl	1
numberOfDay	Year.ttl	1
numberOfMonth	Year.ttl	1
numberOfYear	Year.ttl	1
precededBy	Year.ttl	1
year	Year.ttl	1
yearID	Year.ttl	1
yearNumber	Year.ttl	1
assertedBy	Fact.ttl	1
dateRecorded	Fact.ttl	1
dateVerified	Fact.ttl	1
factStatement	Fact.ttl	1
hasCategoryName	Fact.ttl	1
hasDateVerified	Fact.ttl	1
hasFact	Fact.ttl	1
hasFactSource	Fact.ttl	1
hasFactText	Fact.ttl	1
hasFactTopic	Fact.ttl	1
hasFactType	Fact.ttl	1
hasFactValue	Fact.ttl	1
hasId	Fact.ttl	1
hasObject	Fact.ttl	1
hasPredicate	Fact.ttl	1
hasReporter	Fact.ttl	1
hasSourceName	Fact.ttl	1
hasSourceUrl	Fact.ttl	1
hasStatement	Fact.ttl	1
hasVerification	Fact.ttl	1
hasVerificationStatus	Fact.ttl	1
isFactAbout	Fact.ttl	1
isFactChecked	Fact.ttl	1
isFactOfCategory	Fact.ttl	1
isSourceVerified	Fact.ttl	1
related_to	Fact.ttl	1
sourceReference	Fact.ttl	1
validity	Fact.ttl	1
verified	Fact.ttl	1
deliversFunction	System.ttl	1
hasApplication	System.ttl	1
hasConfiguration	System.ttl	1
hasElement	System.ttl	1
hasFunctionality	System.ttl	1
hasHardware	System.ttl	1
hasInput	Program.ttl	2
hasObjective	System.ttl	1
hasOperatingSystem	System.ttl	1
hasOutput	Program.ttl	2
hasSoftware	System.ttl	1
hasSubSystem	System.ttl	1
hasSubsystem	System.ttl	1
hasVersion	Program.ttl	2
isComponentOf	System.ttl	1
isInstalledOn	System.ttl	1
partOfSystem	System.ttl	1
performsFunction	System.ttl	1
providesService	Service.ttl	5
subSystem	System.ttl	1
subsystem_of	System.ttl	1
breathe	Life.ttl	1
consume	Life.ttl	1
eat	Life.ttl	1
grow	Life.ttl	1
habitat	Life.ttl	1
hasBirth	Life.ttl	1
hasCells	Life.ttl	1
hasDeath	Life.ttl	1
hasEnvironment	Life.ttl	1
hasLife	Life.ttl	1
hasLifeCycle	Life.ttl	1
hasLifeSpan	Life.ttl	1
hasLifeStage	Life.ttl	1
hasOrganism	Life.ttl	1
hasTaxonomicRank	Life.ttl	1
lifeSpan	Life.ttl	1
lifespan	Life.ttl	1
reproduce	Life.ttl	1
female	Girl.ttl	1
girlAge	Girl.ttl	1
girlName	Girl.ttl	1
hasBirthday	Member.ttl	2
hasPets	Girl.ttl	1
hasToys	Girl.ttl	1
isGirl	Girl.ttl	1
containsRoom	Home.ttl	1
equippedWith	Home.ttl	1
hasFloor	Home.ttl	1
hasHome	Home.ttl	1
hasResidents	Home.ttl	1
hasRoof	Home.ttl	1
inCity	Home.ttl	1
isHomeOf	Home.ttl	1
ownerOf	Home.ttl	1
cEO	Company.ttl	1
company	Work.ttl	2
employeeCount	Company.ttl	1
employsPerson	Company.ttl	1
foundedDate	Company.ttl	1
foundedIn	Company.ttl	1
hasCEO	Business.ttl	2
hasCompanyName	Work.ttl	2
hasDirector	Company.ttl	1
hasEmployeeCount	Company.ttl	1
hasFoundingDate	Company.ttl	1
hasFullName	Work.ttl	3
hasIndustry	Company.ttl	1
hasRevenue	Company.ttl	1
headquarterLocation	Company.ttl	1
offers	School.ttl	3
operatesIn	Health.ttl	3
personAge	Community.ttl	2
personNationality	Company.ttl	1
produces	Business.ttl	2
roleName	Company.ttl	1
yearEstablished	Company.ttl	1
zipCode	Company.ttl	1
artGenre	Art.ttl	1
artist	Art.ttl	1
artistName	Art.ttl	1
artistNationality	Art.ttl	1
artworkTitle	Art.ttl	1
belongsGenre	Art.ttl	1
created	Art.ttl	1
createdBy	Art.ttl	1
created_by	Art.ttl	1
creates	Art.ttl	1
display	Art.ttl	1
displayed_at	Art.ttl	1
exhibitedIn	Art.ttl	1
exhibits	Art.ttl	1
hasArtStyle	Art.ttl	1
hasArtist	Art.ttl	1
hasCreated	Art.ttl	1
hasCreator	Idea.ttl	2
hasMedium	Way.ttl	2
has_genre	Art.ttl	1
housesArt	Art.ttl	1
inPeriod	Art.ttl	1
inspiredBy	Idea.ttl	2
mass	Art.ttl	1
medium	Art.ttl	1
mediumName	Art.ttl	1
modern	Art.ttl	1
periodName	Art.ttl	1
shownAt	Art.ttl	1
styleName	Art.ttl	1
usesMedium	Art.ttl	1
uses_medium	Art.ttl	1
activity	Community.ttl	1
attendsEvent	Community.ttl	1
belongs	Community.ttl	1
commentedBy	Community.ttl	1
communityLeader	Community.ttl	1
communityLocation	Community.ttl	1
communityMember	Community.ttl	1
communityName	Community.ttl	1
coordinator	Community.ttl	1
eventDate	Community.ttl	1
goal	Community.ttl	1
hasComment	Result.ttl	2
hasCommunityRole	Community.ttl	1
hasCultural_Identity	Community.ttl	1
hasCulture	Community.ttl	1
hasInstitution	Community.ttl	1
hasPost	Community.ttl	1
hasVolunteer	Community.ttl	1
holdsEvent	Community.ttl	1
joined	Community.ttl	1
joinedDate	Member.ttl	2
leaderName	Community.ttl	1
locatedAt	Service.ttl	2
memberCount	Community.ttl	1
organizedBy	Party.ttl	2
postDate	Community.ttl	1
postTitle	Community.ttl	1
volunteerName	Community.ttl	1
entityName	Name.ttl	1
familyName	Name.ttl	1
fullName	Work.ttl	2
givenName	Name.ttl	1
hasMiddleName	Name.ttl	1
hasNamePrefix	Name.ttl	1
hasNameSuffix	Name.ttl	1
hasNickName	Name.ttl	1
hasPrefix	Name.ttl	1
hasSuffix	Name.ttl	1
hasfirstName	Name.ttl	1
haslastName	Name.ttl	1
hasmiddleName	Name.ttl	1
middleName	Name.ttl	1
namePrefix	Name.ttl	1
nameSuffix	Name.ttl	1
nickName	Name.ttl	1
affectsEntity	Change.ttl	1
changeCausedBy	Change.ttl	1
changeIntensity	Change.ttl	1
changeOccursIn	Change.ttl	1
effects	Change.ttl	1
hasAffectedObject	Change.ttl	1
hasBeginState	Change.ttl	1
hasChange	Change.ttl	1
hasChangeAgent	Change.ttl	1
hasChangeDate	Change.ttl	1
hasChangeEnd	Change.ttl	1
hasChangeEndState	Change.ttl	1
hasChangeStart	Change.ttl	1
hasChangeStartState	Change.ttl	1
hasChangeType	Change.ttl	1
hasContext	Change.ttl	1
hasEndState	Change.ttl	1
hasFinalValue	Change.ttl	1
hasImpact	Idea.ttl	3
hasInitialValue	Change.ttl	1
hasInitiator	Change.ttl	1
hasNewState	Change.ttl	1
hasOldState	Change.ttl	1
hasStartState	Change.ttl	1
hasTarget	Change.ttl	1
hasTypeOfChange	Change.ttl	1
isCausedBy	Problem.ttl	2
isChangeOf	Change.ttl	1
isTriggeredBy	Change.ttl	1
occurrenceTime	Change.ttl	1
occursAt	Change.ttl	1
hasCode	Program.ttl	1
hasDeveloperName	Program.ttl	1
hasExperience	Teacher.ttl	3
hasLicense	Program.ttl	1
hasPlatformCompatibility	Program.ttl	1
hasProgramName	Program.ttl	1
isCreatedBy	Program.ttl	1
isWrittenIn	Program.ttl	1
knowsLanguage	Program.ttl	1
provider	Service.ttl	2
runOnOperatingSystem	Program.ttl	1
runsOn	Program.ttl	1
usesLanguage	Program.ttl	1
usesLibrary	Program.ttl	1
version	Program.ttl	1
writtenIn	Program.ttl	1
appliesPageLayout	Word.ttl	1
documentTitle	Word.ttl	1
hasAntonym	Word.ttl	1
hasDefinition	Word.ttl	1
hasLemma	Word.ttl	1
hasMeaning	Word.ttl	1
hasOrigin	Idea.ttl	2
hasPartOfSpeech	Word.ttl	1
hasSpelling	Word.ttl	1
hasSpellingCorrector	Word.ttl	1
hasSynonym	Word.ttl	1
hasSynonyms	Word.ttl	1
hasThesaurus	Word.ttl	1
hasWordProperty	Word.ttl	1
isInLanguage	Word.ttl	1
isPartOfSpeech	Word.ttl	1
isSynonymOf	Word.ttl	1
partOfSpeech	Word.ttl	1
sentence	Word.ttl	1
spelling	Word.ttl	1
upos	Word.ttl	1
usedInSentence	Word.ttl	1
usesMailMerge	Word.ttl	1
wordVersion	Word.ttl	1
arriveAt	Way.ttl	1
aspectOfWay	Way.ttl	1
condition	Way.ttl	1
connectedTo	Way.ttl	1
connects	Way.ttl	1
coveredBy	Way.ttl	1
departFrom	Way.ttl	1
destination	Way.ttl	1
distance	Way.ttl	1
endPoint	Line.ttl	2
from	Way.ttl	1
hasDestination	Way.ttl	1
hasDestinationType	Way.ttl	1
hasDirection	Force.ttl	3
hasDistance	Way.ttl	1
hasEndPoint	Line.ttl	2
hasSourceType	Way.ttl	1
hasStartPoint	Line.ttl	2
hasTraffic	Way.ttl	1
hasWay	Way.ttl	1
isAccessible	Way.ttl	1
startPoint	Line.ttl	2
takenBy	Way.ttl	1
to	Way.ttl	1
understandsWay	Way.ttl	1
usedFor	Way.ttl	1
buys	Business.ttl	1
buysFrom	Business.ttl	1
empName	Business.ttl	1
employeeOf	Business.ttl	1
generates	Business.ttl	1
hasBusinessLocation	Business.ttl	1
hasHeadquarters	Business.ttl	1
hasProduct	Business.ttl	1
hasSector	Business.ttl	1
hires	Business.ttl	1
isFundedBy	Business.ttl	1
locName	Business.ttl	1
offers	Business.ttl	1
offersProduct	Business.ttl	1
operatesIn	Business.ttl	1
prodName	Business.ttl	1
producesProduct	Business.ttl	1
revenue	Business.ttl	1
sectorName	Business.ttl	1
sells	Business.ttl	1
serves	Business.ttl	1
serviceName	Service.ttl	2
supplies	Business.ttl	1
belongsToDomain	Problem.ttl	1
causeDescription	Problem.ttl	1
hasComplexity	Problem.ttl	1
hasDetails	Problem.ttl	1
hasDifficulty	Level.ttl	2
hasDifficultyLevel	Question.ttl	2
hasEffect	Problem.ttl	1
hasProblem	Problem.ttl	1
hasRelatedProblem	Problem.ttl	1
hasSeverity	Health.ttl	3
hasSolution	Problem.ttl	1
hasStep	Problem.ttl	1
hasTimeToSolve	Problem.ttl	1
isComplex	Problem.ttl	1
isSolutionOf	Problem.ttl	1
isSolvedBy	Problem.ttl	1
isTypeOf	Problem.ttl	1
issueName	Problem.ttl	1
problem	Problem.ttl	1
problemDescription	Problem.ttl	1
problemSolution	Problem.ttl	1
severity	Problem.ttl	1
solution	Problem.ttl	1
solutionDescription	Problem.ttl	1
timeToSolve	Problem.ttl	1
eyeColor	Face.ttl	1
hasCheek	Face.ttl	1
hasExpression	Face.ttl	1
hasFacialFeature	Face.ttl	1
hasFeature	Face.ttl	1
hasSkinColor	Hand.ttl	2
hasSkinType	Face.ttl	1
mouthSize	Face.ttl	1
noseSize	Face.ttl	1
shape	Eye.ttl	2
skinTone	Face.ttl	1
hasArm	Body.ttl	1
hasBodyPart	Body.ttl	1
hasLeg	Body.ttl	1
hasLimbs	Body.ttl	1
hasOrgan	Body.ttl	1
hasTorso	Body.ttl	1
even	Number.ttl	1
greaterThan	Number.ttl	1
imaginaryPart	Number.ttl	1
isDivisibleBy	Number.ttl	1
isEqual	Number.ttl	1
isEven	Number.ttl	1
isGreaterThan	Number.ttl	1
isImaginary	Number.ttl	1
isIrrational	Number.ttl	1
isLessThan	Number.ttl	1
isNegative	Number.ttl	1
isPositive	Number.ttl	1
lessThan	Number.ttl	1
negative	Number.ttl	1
numberValue	Number.ttl	1
numberValueFloat	Number.ttl	1
numberValueInteger	Number.ttl	1
realPart	Number.ttl	1
hasCoordinate	Line.ttl	1
hasXYCoordinates	Line.ttl	1
isParallelTo	Line.ttl	1
isPerpendicularTo	Line.ttl	1
isStraight	Line.ttl	1
slope	Line.ttl	1
cityCountry	People.ttl	1
cityCounty	People.ttl	1
marriedTo	People.ttl	1
bodyType	Car.ttl	1
engineType	Car.ttl	1
fuelType	Car.ttl	1
hasEngine	Car.ttl	1
hasEngineSize	Car.ttl	1
hasMake	Car.ttl	1
hasModel	Car.ttl	1
hasProductionYear	Car.ttl	1
hasRegistrationYear	Car.ttl	1
hasVIN	Car.ttl	1
horsePower	Car.ttl	1
make	Car.ttl	1
company	Book.ttl	1
hasISBN	Book.ttl	1
hasPageCount	Book.ttl	1
hasPublisher	Book.ttl	1
iSBN	Book.ttl	1
isbn	Book.ttl	1
numberOfPages	Book.ttl	1
pages	Book.ttl	1
publishBy	Book.ttl	1
publishedDate	Book.ttl	1
publishedYear	Book.ttl	1
assignee	Issue.ttl	1
closedDate	Issue.ttl	1
createdDate	Issue.ttl	1
hasCreatedDate	Issue.ttl	1
hasDateCreated	Idea.ttl	2
hasDateResolved	Issue.ttl	1
hasDeadline	Team.ttl	3
hasIssue	Issue.ttl	1
hasIssueDateCreated	Issue.ttl	1
hasIssueDescription	Issue.ttl	1
hasIssueIdentifier	Issue.ttl	1
hasIssueStatus	Issue.ttl	1
hasIssueTitle	Issue.ttl	1
hasPriority	Issue.ttl	1
hasResolutionStatus	Issue.ttl	1
hasResponsible	Issue.ttl	1
isAssignedTo	Issue.ttl	1
isIssueOf	Issue.ttl	1
issueDate	Issue.ttl	1
issueDescription	Issue.ttl	1
issueID	Issue.ttl	1
issuePriority	Issue.ttl	1
issueResolved	Issue.ttl	1
issueSeverity	Issue.ttl	1
issueStatus	Issue.ttl	1
issueTitle	Issue.ttl	1
issueType	Issue.ttl	1
personEmail	Issue.ttl	1
priority	Issue.ttl	1
reporter	Issue.ttl	1
resolvedDate	Issue.ttl	1
resolvesIssue	Issue.ttl	1
responsibleParty	Issue.ttl	1
administersTreatment	Health.ttl	1
admittedIn	Health.ttl	1
diagnosedWith	Health.ttl	1
diagnoses	Health.ttl	1
disease	Eye.ttl	2
hasAilment	Health.ttl	1
hasCondition	Back.ttl	2
hasDiagnosis	Health.ttl	1
hasDietRestriction	Health.ttl	1
hasDisease	Eye.ttl	2
hasDoctor	Health.ttl	1
hasGymMembership	Health.ttl	1
hasHealth	Health.ttl	1
hasHealthRecord	Health.ttl	1
hasHealthStatus	Health.ttl	1
hasIllness	Health.ttl	1
hasMedication	Health.ttl	1
hasMentalHealth	Health.ttl	1
hasMentalHealthStatus	Health.ttl	1
hasPatient	Health.ttl	1
hasPhysicalHealth	Health.ttl	1
hasPhysicalHealthStatus	Health.ttl	1
hasPhysicalHeathStatus	Health.ttl	1
hasSideEffect	Health.ttl	1
hasSymptom	Back.ttl	2
hasTreatment	Eye.ttl	2
includesMedication	Health.ttl	1
includesSymptom	Health.ttl	1
isDiagnosedWith	Health.ttl	1
isFollowingTreatment	Health.ttl	1
isTreatedBy	Health.ttl	1
isTreatedWith	Health.ttl	1
medicationName	Health.ttl	1
prescribedBy	Health.ttl	1
prescribedFor	Health.ttl	1
prescribes	Health.ttl	1
prescribesMedication	Health.ttl	1
receives	Education.ttl	3
receivesTreatment	Health.ttl	1
suffersFrom	Back.ttl	2
takesMedication	Health.ttl	1
treatmentFor	Health.ttl	1
treats	Health.ttl	1
usedMedication	Health.ttl	1
assigns	Education.ttl	2
attend	School.ttl	1
completes	School.ttl	1
hasClass	School.ttl	1
hasPrincipal	School.ttl	1
hasTeacher	Education.ttl	2
includesGrade	School.ttl	1
learns	School.ttl	1
numberOfStudents	School.ttl	1
offeredAt	School.ttl	1
offersCourse	Education.ttl	2
schoolName	School.ttl	1
schoolhasGrade	School.ttl	1
schoolhasStudent	School.ttl	1
schoolhasSubject	School.ttl	1
schoolhasTeacher	School.ttl	1
schoollocatedIn	School.ttl	1
teachesSubject	Teacher.ttl	3
studentAge	School.ttl	1
studiesUnder	School.ttl	1
studyingIn	School.ttl	1
takesCourse	School.ttl	1
teacherAge	School.ttl	1
teacherName	School.ttl	1
teachesAt	Teacher.ttl	2
teachesCourse	Education.ttl	2
teachesIn	Teacher.ttl	2
teachesSubject	School.ttl	1
answerText	Question.ttl	1
asked	Question.ttl	1
askedBy	Question.ttl	1
askedIn	Question.ttl	1
drawsFromSource	Question.ttl	1
hasAnswer	Question.ttl	1
hasAnswerText	Question.ttl	1
hasBody	Question.ttl	1
hasChoice	Question.ttl	1
hasQuestion	Question.ttl	1
hasQuestionText	Question.ttl	1
hasResponse	Question.ttl	1
hasSpecificDate	Question.ttl	1
isAnsweredBy	Question.ttl	1
isAskedBy	Question.ttl	1
isCorrect	Question.ttl	1
isCorrectAnswer	Question.ttl	1
isRelatedToTopic	Question.ttl	1
isResponseTo	Question.ttl	1
possibleAnswer	Question.ttl	1
questionText	Question.ttl	1
relatedToTopic	Question.ttl	1
sourceName	Question.ttl	1
sourceType	Question.ttl	1
sourceURL	Question.ttl	1
text	Question.ttl	1
topicOf	Question.ttl	1
areaInSqKm	City.ttl	1
capitalOf	City.ttl	1
cityContainedInCountry	City.ttl	1
countryName	City.ttl	1
elevation	City.ttl	1
hasMayor	City.ttl	1
isCapital	City.ttl	1
isCapitalOf	City.ttl	1
isInCountry	City.ttl	1
locatedInCountry	State.ttl	2
timeZone	City.ttl	1
hasFinalOutcome	Result.ttl	1
hasProcess	Result.ttl	1
hasScore	Result.ttl	1
hasSuccess	Result.ttl	1
isResultOf	End.ttl	2
isSuccess	Result.ttl	1
outcome	Result.ttl	1
score	Result.ttl	1
timestamp	Result.ttl	1
wasGeneratedBy	Result.ttl	1
citizenAge	Government.ttl	1
createsLaw	Government.ttl	1
department	Government.ttl	1
departmentOf	Government.ttl	1
director	Government.ttl	1
enforcesLaw	Government.ttl	1
established	Government.ttl	1
governedBy	Government.ttl	1
governmentName	Government.ttl	1
governmentType	Government.ttl	1
governs	Government.ttl	1
hasBranch	Government.ttl	1
hasCitizen	Government.ttl	1
hasGovernment	Government.ttl	1
hasHeadOfState	Government.ttl	1
hasLaw	Government.ttl	1
hasLaws	Government.ttl	1
hasPolicy	Government.ttl	1
hasSystem	Government.ttl	1
headOf	Government.ttl	1
headOfGovernment	Government.ttl	1
holdsPosition	Government.ttl	1
implements	Government.ttl	1
isBranchOf	Government.ttl	1
isHeadedBy	Government.ttl	1
leaderOf	Government.ttl	1
legislation	Government.ttl	1
mayorOf	Government.ttl	1
official	Government.ttl	1
passes	Government.ttl	1
positionIn	Government.ttl	1
containsState	State.ttl	1
hasStateCapital	State.ttl	1
isPartOfCountry	State.ttl	1
stateName	State.ttl	1
livesAt	Child.ttl	1
parent	Child.ttl	1
parentOf	Child.ttl	1
belongsInCategory	Work.ttl	1
companyName	Work.ttl	1
employed	Work.ttl	1
employedBy	Work.ttl	1
employeeID	Work.ttl	1
hasJobPosting	Work.ttl	1
hasPlace	Work.ttl	1
hasTask	Team.ttl	2
hasWorkHours	Work.ttl	1
hasWorker	Work.ttl	1
hoursPerWeek	Work.ttl	1
isEmployedAt	Work.ttl	1
isPerformedBy	Work.ttl	1
isRemote	Work.ttl	1
organization	Work.ttl	1
performWork	Work.ttl	1
workName	Work.ttl	1
worker	Work.ttl	1
actsOn	Force.ttl	1
appliedBy	Force.ttl	1
appliedOn	Force.ttl	1
applied_to	Force.ttl	1
appliesForce	Force.ttl	1
direction	Force.ttl	1
directionOfForce	Force.ttl	1
forceDirection	Force.ttl	1
forceValue	Force.ttl	1
hasForce	Force.ttl	1
hasForceDirection	Force.ttl	1
hasForceMagnitude	Force.ttl	1
hasForceValue	Force.ttl	1
hasStrength	Force.ttl	1
isAppliedTo	Force.ttl	1
isForceOf	Force.ttl	1
magnitude	Force.ttl	1
magnitudeOfForce	Force.ttl	1
newton	Force.ttl	1
resistsForce	Force.ttl	1
resultant_effect	Force.ttl	1
affects	Back.ttl	1
associatedCondition	Back.ttl	1
hasBack	Back.ttl	1
hasInjury	Back.ttl	1
hasMuscle	Back.ttl	1
hasPain	Back.ttl	1
hasSpine	Back.ttl	1
isLocationOf	Back.ttl	1
isOppositeOf	Back.ttl	1
painLevel	Back.ttl	1
partOfBack	Back.ttl	1
treatmentPlan	Back.ttl	1
belongsToObject	Side.ttl	1
hasBackSide	Side.ttl	1
hasFrontSide	Side.ttl	1
hasLeftSide	Side.ttl	1
hasOpponent	Side.ttl	1
hasOrientation	Side.ttl	1
hasRelatedObject	Side.ttl	1
hasRightSide	Side.ttl	1
hasSide	Side.ttl	1
hasSideType	Side.ttl	1
isSideOf	Side.ttl	1
opposite	Side.ttl	1
oppositeTo	Side.ttl	1
symmetricTo	Side.ttl	1
grantedBy	Right.ttl	1
hasRight	Right.ttl	1
hasRightHolder	Right.ttl	1
hasScope	Right.ttl	1
holder	Right.ttl	1
isGrantedBy	Right.ttl	1
isGrantedTo	Right.ttl	1
isProtectedBy	Right.ttl	1
isRightOf	Right.ttl	1
possession	Right.ttl	1
protectedBy	Right.ttl	1
providesRight	Right.ttl	1
rightInJurisdiction	Right.ttl	1
rightToEquality	Right.ttl	1
rightToLife	Right.ttl	1
rightToReligiousFreedom	Right.ttl	1
rightToVote	Right.ttl	1
violatedBy	Right.ttl	1
cause	End.ttl	1
endtime	End.ttl	1
event	End.ttl	1
hasActor	End.ttl	1
hasEndLocation	End.ttl	1
isEndOf	End.ttl	1
locationEnd	End.ttl	1
of	End.ttl	1
ofEvent	End.ttl	1
timePoint	End.ttl	1
hasCaptain	Team.ttl	1
hasCoach	Team.ttl	1
hasMemberExperience	Team.ttl	1
hasMemberName	Team.ttl	1
hasMemberRole	Team.ttl	1
hasNumberOfPlayers	Team.ttl	1
hasProject	Team.ttl	1
hasProjectDeadline	Team.ttl	1
hasProjectName	Team.ttl	1
hasSport	Team.ttl	1
hasTeamLead	Team.ttl	1
hasTeamLeader	Team.ttl	1
hasTeamName	Team.ttl	1
isOfAge	Team.ttl	1
league	Team.ttl	1
playsIn	Team.ttl	1
position	Team.ttl	1
sport	Team.ttl	1
sportName	Team.ttl	1
teamLeader	Team.ttl	1
teamName	Team.ttl	1
courseID	Education.ttl	1
educates	Education.ttl	1
hasDegree	Teacher.ttl	2
hasEducation	Education.ttl	1
hasEducationalInstitution	Education.ttl	1
hasEnrolled	Education.ttl	1
hasKnowledgeArea	Education.ttl	1
offeredBy	Service.ttl	2
schooledIn	Education.ttl	1
studentId	Education.ttl	1
teacherID	Education.ttl	1
teacherId	Education.ttl	1
universityAttended	Education.ttl	1
universityID	Education.ttl	1
cost	Service.ttl	1
hasConsumer	Service.ttl	1
hasCost	Service.ttl	1
hasCustomer	Service.ttl	1
hasProvider	Service.ttl	1
hasRate	Service.ttl	1
hasServiceConsumer	Service.ttl	1
hasServiceDuration	Service.ttl	1
hasServiceProvider	Service.ttl	1
isPaid	Service.ttl	1
isProvidedBy	Service.ttl	1
providedBy	Service.ttl	1
providerLocation	Service.ttl	1
providerName	Service.ttl	1
serviceConsumer	Service.ttl	1
serviceCost	Service.ttl	1
serviceProvider	Service.ttl	1
serviceRating	Service.ttl	1
serviceType	Service.ttl	1
usesService	Service.ttl	1
belongsGroup	Member.ttl	1
belongsToGroup	Member.ttl	1
groupHasName	Member.ttl	1
hasEmail	Member.ttl	1
hasJoinedDate	Member.ttl	1
hasMemberID	Member.ttl	1
hasMembershipDate	Member.ttl	1
hasMembershipSince	Member.ttl	1
hasMembershipType	Member.ttl	1
isMemberOf	Member.ttl	1
joinedOn	Member.ttl	1
livesInCity	Member.ttl	1
memberID	Member.ttl	1
membershipType	Member.ttl	1
prov	Member.ttl	1
hasLevelName	Level.ttl	1
hasLevelNumber	Level.ttl	1
hasNextLevel	Level.ttl	1
hasReward	Level.ttl	1
hasSkill	Level.ttl	1
inGame	Level.ttl	1
isLevelOf	Level.ttl	1
levelDescription	Level.ttl	1
levelIndicator	Level.ttl	1
levelName	Level.ttl	1
levelNumber	Level.ttl	1
levelOf	Level.ttl	1
levelValue	Level.ttl	1
nextLevel	Level.ttl	1
previousLevel	Level.ttl	1
understanding	Level.ttl	1
canGrasp	Hand.ttl	1
canGrip	Hand.ttl	1
fingerCount	Hand.ttl	1
fingers	Hand.ttl	1
handHasFingers	Hand.ttl	1
handHasPalm	Hand.ttl	1
handHasThumb	Hand.ttl	1
hasFingers	Hand.ttl	1
hasFiveFingers	Hand.ttl	1
hasNails	Hand.ttl	1
hasNumberOfFingers	Hand.ttl	1
hasPalm	Hand.ttl	1
hasParts	Hand.ttl	1
hasThumb	Hand.ttl	1
isLeft	Hand.ttl	1
isPartOfArm	Hand.ttl	1
isRight	Hand.ttl	1
associatedWithConcept	Idea.ttl	1
dateOfIdea	Idea.ttl	1
descriptionOfIdea	Idea.ttl	1
evaluation	Idea.ttl	1
hasCreationDate	Idea.ttl	1
hasIdea	Idea.ttl	1
hasIdeaValue	Idea.ttl	1
hasOriginality	Idea.ttl	1
hasOriginator	Idea.ttl	1
hasRelation	Idea.ttl	1
hasResultingAction	Idea.ttl	1
ideaBelongsTo	Idea.ttl	1
ideaContent	Idea.ttl	1
ideaCreationDate	Idea.ttl	1
ideaOriginator	Idea.ttl	1
ideaSummary	Idea.ttl	1
implementationStatus	Idea.ttl	1
inspirationSource	Idea.ttl	1
isImplemented	Idea.ttl	1
isInspiredBy	Idea.ttl	1
isOriginal	Idea.ttl	1
leadTo	Idea.ttl	1
practicality	Idea.ttl	1
canSee	Eye.ttl	1
cornea	Eye.ttl	1
eyeCondition	Eye.ttl	1
eyeShape	Eye.ttl	1
eyeVision	Eye.ttl	1
function	Eye.ttl	1
hasAnatomy	Eye.ttl	1
hasCiliaryMuscle	Eye.ttl	1
hasCornea	Eye.ttl	1
hasDisorder	Eye.ttl	1
hasIris	Eye.ttl	1
hasKinesthesia	Eye.ttl	1
hasLens	Eye.ttl	1
hasLensType	Eye.ttl	1
hasRetina	Eye.ttl	1
hasVision	Eye.ttl	1
hasVisualAcuity	Eye.ttl	1
iris	Eye.ttl	1
lens	Eye.ttl	1
lensMaterial	Eye.ttl	1
lensShape	Eye.ttl	1
lensThickness	Eye.ttl	1
retina	Eye.ttl	1
sight	Eye.ttl	1
vision	Eye.ttl	1
vission	Eye.ttl	1
hasAuctionDate	Lot.ttl	1
hasBuilding	Lot.ttl	1
hasLot	Lot.ttl	1
hasLotNumber	Lot.ttl	1
hasParkingLot	Lot.ttl	1
hasStartingPrice	Lot.ttl	1
hasStreetAddress	Lot.ttl	1
hasStructure	Lot.ttl	1
hasZipCode	Lot.ttl	1
identifier	Lot.ttl	1
isAvailable	Lot.ttl	1
isDeveloped	Lot.ttl	1
isForSale	Lot.ttl	1
isOnSale	Lot.ttl	1
isPartOfAuction	Lot.ttl	1
isVacant	Lot.ttl	1
lotNumber	Lot.ttl	1
lotSize	Lot.ttl	1
owners	Lot.ttl	1
salePrice	Lot.ttl	1
first_name	Teacher.ttl	1
hasExperienceInYears	Teacher.ttl	1
hasYearsExperience	Teacher.ttl	1
isEmployedBy	Teacher.ttl	1
last_name	Teacher.ttl	1
subjectName	Teacher.ttl	1
teachSubject	Teacher.ttl	1
teaches_subject	Teacher.ttl	1
worksAtSchool	Teacher.ttl	1
works_at	Teacher.ttl	1
yearsExperience	Teacher.ttl	1
yearsOfExperience	Teacher.ttl	1
attendedBy	Party.ttl	1
attendee	Party.ttl	1
guest	Party.ttl	1
hasAttendee	Party.ttl	1
hasGuest	Party.ttl	1
hasHost	Party.ttl	1
hasOrganizer	Party.ttl	1
hasPartyType	Party.ttl	1
hostedBy	Party.ttl	1
music	Party.ttl	1
organisedBy	Party.ttl	1
theme	Party.ttl	1
zipcode	Party.ttl	1
